日新月异	日新月异 🌞❤🌙👆
三阳开泰	三阳开泰 👌🐑🚗🌞
盲人摸象	盲人摸象 😵👦👐🐘 😲👲🙌🐘
千夫所指	千夫所指 💴👨🔒🈯 💰👰🔒👉
生龙活虎	生龙活虎 🎂🐲🔥🐯 🔊🐲🔥🐯
日日夜夜	日日夜夜 🌕🌕🌑🌑
琳琅满目	琳琅满目 🔔🐺🈵👀
七嘴八舌	七嘴八舌 7⃣👄8⃣👅 🎈💋🕗👅 🎈👄👈🐍
声色犬马	声色犬马 🎼😍🐶🐎
三从四德	三从四德 🕒🌾🕓🉐
四面楚歌	四面楚歌 🕓🍜🔍🎤
虎口余生	虎口余生 🐅👄🐳🎂
走马观花	走马观花 🚶🐴✖💐 🚶🐴👀🌸 👣🐎👀🌺
以牙还牙	以牙还牙 👕👄⭕👄
震耳欲聋	震耳欲聋 💉👂🐠🙉
以人为镜	以人为镜 👕🙎📞🔍
趾高气扬	趾高气扬 👆🎂🎈🐑 👉🍰🎈🐐
风雨凄凄	风雨凄凄 💨☔🕖🕖
赞不绝口	赞不绝口 👍🙅🚫👄
博览五车	博览五车 🍍👀5⃣🚗
博而不精	博而不精 🍍👂❌🐳
兔死狐悲	兔死狐悲 🐰4⃣🐺🍸
风行电击	风行电击 💨🚶⚡🐔
以夷制夷	以夷制夷 👕👚🍹👚 👕👚🍹👚
满面红光	满面红光 🈵🍜🔴💥
八仙过海	八仙过海 8⃣👸🏃🌊
火树银花	火树银花 🔥🎄🎼🌸
五花八门	五花八门 5⃣🌸8⃣🚪
相见恨晚	相见恨晚 📷👀😠🌌
首屈一指	首屈一指 🎅✊1⃣🈯
五光十色	五光十色 ✋✨➕😻
水木清华	水木清华 💦🌳💚🌸
三心二意	三心二意 🕒💕🕑➖
男欢女爱	男欢女爱 🚶☺💃💏
冰心一片	冰心一片 🍪❤👆♦
八方支援	八方支援 8⃣◾🍹⚪
鸡头鱼刺	鸡头鱼刺 🐔👦🐠🔪
口口声声	口口声声 👄👄🔊🔊
原封不动	原封不动 ⚪✉🙅⭕
沐猴衣冠	沐猴衣冠 🛀🐒👕🎩
刀光血影	刀光血影 🔪🌅❄👤
治病救人	治病救人 📃❄🕘🙎
前车之鉴	前车之鉴 💴🚗🍸🚀
一朝一夕	一朝一夕 👆🌞👆🌙
以观后效	以观后效 👕👀🐒😄
令人注目	令人注目 🔔👦🐷👀
两手空空	两手空空 🕑✋⭕⭕
三羊开泰	三羊开泰 👌🐑🚗🌞
传道受业	传道受业 🚢🍴✋🍃 🚤🔪🙌🌿
两叶掩目	两叶掩目 🕑🍃🚬👀
五零四散	五零四散 🈚0⃣4⃣☔
足食足兵	足食足兵 👣🍚👣🍪
十风五雨	十风五雨 🕙💨5⃣☔
儿女亲家	儿女亲家 👦👧😚🏡
以德报怨	以德报怨 👕🉐👜⚪
白面儒冠	白面儒冠 ◻👦🍼🎩
凤舞龙飞	凤舞龙飞 💨💃🐉✈
茶饭不思	茶饭不思 ☕🍚🙅😔
朝三暮四	朝三暮四 ☀🕒🌙🕓
爱屋及乌	爱屋及乌 💕🏠🐔🏠
朝思暮想	朝思暮想 ☀4⃣🌛🐘
鸡同鸭讲	鸡同鸭讲 🐔🚽🐥📢
代代相承	代代相承 💼👜📷🍊
国色天香	国色天香 🍲😻⛅♨
一针见血	一针见血 ☝💉🚀⛄ 👕💉🚀⛄
马革裹尸	马革裹尸 🐎👦🍎💩
余音绕梁	余音绕梁 🐠🎼➰🍚 🐠🎶🌀🍚
过眼云烟	过眼云烟 🍎👀☁🚬
珠光宝气	珠光宝气 🔮💥💎🎈
一心一意	一心一意 👆❤➖👆
心口如一	心口如一 ❤👄🍼👆
当家立业	当家立业 🔔🏠🍐🌿
滔滔不绝	滔滔不绝 🌊🌊❌🈲
梨花带雨	梨花带雨 🍐🌹💰🌂
狼烟四起	狼烟四起 🐺🚬4⃣🚩 🐺🚬🍅🎆
龙马精神	龙马精神 🐉🐎✨👼
十全十美	十全十美 🕙👊🔟😻
雷声震耳	雷声震耳 💣💤💉👂 💣💤💉👂;
龙盘虎踞	龙盘虎踞 🐲💽🐅🍊
食古不化	食古不化 💩💀🙅💐
云泥之差	云泥之差 ☁🌾🈯✖
漫天要价	漫天要价 🈵☁🔑🏠
依依不舍	依依不舍 👕👕❌🏡
代代相传	代代相传 👜👜🐘⛵
饱经世故	饱经世故 💼🐳💩💀
两败俱伤	两败俱伤 2⃣⚪🍊🔝
以古为鉴	以古为鉴 👚💀📞✂
衣食住行	衣食住行 👕🍚🏠🚴
行云流水	行云流水 ⭐☁6⃣💦
手足无措	手足无措 ✋👣⭕❌
人走茶凉	人走茶凉 🙎🏃☕❄ 👦🏃🍵⛄
心如刀割	心如刀割 ❤🍼🔪🈹
喜上眉梢	喜上眉梢 😄⬆🌹🔥
小鸟依人	小鸟依人 😀🐤1⃣🙎
养家活口	养家活口 🐑🏡🔥👄
两意三心	两意三心 2⃣➖3⃣💕
依山傍水	依山傍水 👕🗻💪💧
睹物思人	睹物思人 👀🈚4⃣🙎
风行一世	风行一世 🌀🌠🕐🔟 🌀⭐👆🕙
吹吹打打	吹吹打打 🎺🎺🔨🔨
侯门似海	侯门似海 🐒🚪4⃣🌊 🐵🚪🍅🌊
一日三月	一日三月 ☝🌞3⃣🌙
鸡飞蛋打	鸡飞蛋打 🐔✈🍳👊 🐔✈🍳🔨
归心似箭	归心似箭 🐢💕🍅🚀 🐢❤️🍅🚀
人琴俱逝	人琴俱逝 🙎🎹🍊🔟
杯水车薪	杯水车薪 🍸💦🚗🆕 😞💧🚖✉ ☕💧🚗🆕 🍸☕️🚄💚
人山人海	人山人海 👱🗻👱🌊 👴🌋👵🌊
望眼欲穿	望眼欲穿 🔭👀🌽🚣 🔭👀🌽🚢
蛇鼠一窝	蛇鼠一窝 🐍🐭☝♨
马马虎虎	马马虎虎 🐎🐎🐅🐅 🐴🐴🐯🐯 🦄🦄🐯🐯 🐴🦄🐯🐯
心口不一	心口不一 💕👅✖👆 💓👄✋👔
琴棋书画	琴棋书画 🎻🚩📚🎨 🎻🚩📖🌺
一板一眼	一板一眼 👆🎬👆👀
行尸走肉	行尸走肉 🚶💀🏃🍗
人事不醒	人事不醒 👦💩❌✨
笔下生花	笔下生花 ✒⬇🎂🌺
白马非马	白马非马 ⚪🐎✈🐎
虎视眈眈	虎视眈眈 🐯👀🔴🔴
力不从心	力不从心 🍐🙅🐛❤
花花公子	花花公子 🌸🌷👴👦
雄视一世	雄视一世 🐻💩➖💩
车水马龙	车水马龙 🚗💧🐎🐲 🚙💦🐴🐉 🚑🍸🐴🐲
乐不思蜀	乐不思蜀 😄🙅4⃣🌲
愁眉苦脸	愁眉苦脸 😞🌹💊🙎 😔🌸💊👩 😒
五风十雨	五风十雨 5⃣💨➕☔
刀光剑影	刀光剑影 🔪⚡✂👯 ✂⚡🚀✌
飞龙在天	飞龙在天 ✈🐲👆☁
风华绝代	风华绝代 💨🌸🈲👜
白头偕老	白头偕老 ⚪👨👞👳
兵不厌诈	兵不厌诈 👮☝🐧💣
以耳代目	以耳代目 ➖👂👜👀
人仰马翻	人仰马翻 👦🐑🐴⛵ 👰🐑🐎⛵️
雪上加霜	雪上加霜 ⛄⬆➕❄
饱食终日	饱食终日 💼💩🀄🌞
口口相传	口口相传 👄👄🐘⛵
香草美人	香草美人 🐘🌱💃👦
手高眼低	手高眼低 ✋🍰👀🚕
倚老卖老	倚老卖老 👕👳🌾👳
见微知著	见微知著 🚀📞📃🐷
血雨腥风	血雨腥风 ⛄☔⭐💨
业业兢兢	业业兢兢 🍃🌿🐳🐋
求仁得仁	求仁得仁 ⚽👦🉐👦
语重心长	语重心长 ☔🀄❤🎤
得意之作	得意之作 🉐👚🍹♿
一龙一蛇	一龙一蛇 👆🐉👆🐍
价值连城	价值连城 🏠🍹👨🍊
狐假虎威	狐假虎威 🐺🏩🐱💢 " \"🐺🏩🐱💢 🐺🏩🐱💢
养虎为患	养虎为患 🐑🐯📞🔁
红男绿女	红男绿女 ❤👨💚👩 🌈👦🍃👧
华屋山丘	华屋山丘 🌸🈚🗻⚽
爱不释手	爱不释手 ❤🙅🔟✋
对牛弹琴	对牛弹琴 ✅🐮🎹🎹
猴年马月	猴年马月 🐒📅🐎🈷 🐒📅🐴🌙
风花雪月	风花雪月 🐝🌷❄🌛
杯弓蛇影	杯弓蛇影 🍸👴🐍👤
十十五五	十十五五 🕙🕙🈚🈚
花好月圆	花好月圆 🌸👌🌙🌕 🌷👌🌙⭕
花前月下	花前月下 🌺💰🌙⬇
海枯石烂	海枯石烂 🌊😭🔟🏀 🌊♨️🌋💔
步步惊心	步步惊心 👣👣😱❤
单枪独马	单枪独马 👆🔫1⃣🐎
机不可失	机不可失 🐔🙅🉑🔟
不依不饶	不依不饶 ❌👕🙅⏰
画龙点睛	画龙点睛 🎨🐲⚫👀
虎头虎脑	虎头虎脑 🐯🐯🐯🐯
动手动脚	动手动脚 ⭕✋⭕👣
放虎归山	放虎归山 ♦🐯🐢🗻 ♦️🐯🐢🌋
火烧火燎	火烧火燎 🔥♨🔥♨
竹马之交	竹马之交 🐷🐴📃👣
草木皆兵	草木皆兵 🌾🌲🙎❄
风和日丽	风和日丽 💨👘☀💪
狗急跳墙	狗急跳墙 🐶🐔💃🏢
一针一线	一针一线 👆📌👆➰
返老还童	返老还童 🍚👴⭕👶 🍚👴⭕️👶
画蛇添足	画蛇添足 ✏🐍☁👞
恶语伤人	恶语伤人 🐊🛁🔪👦 🐊☔️🔪👴
六亲不认	六亲不认 6⃣😚🙅👨
刮目相看	刮目相看 🍉👀🐘👀
魑魅魍魉	魑魅魍魉 👹👺💀👻 👺👿💀👻
唇齿相依	唇齿相依 👄😀🐘👆
察言观色	察言观色 ☕👀🎩😍
东奔西走	东奔西走 ❄🏃🍉🚶
与虎添翼	与虎添翼 🐠🐯⛅➖
风流人物	风流人物 💨6⃣👨🏡
业精于勤	业精于勤 🍃🐋🐟🎹
一手一足	一手一足 👆✋👆👣
十指连心	十指连心 💩✋🙎❤
草草收兵	草草收兵 🍀🍀✋🍪
千秋万世	千秋万世 💴🏀🍵➕
绰绰有余	绰绰有余 ❌❌🈶🐠
九九归一	九九归一 🕘🍻🐢👔 🍸🍺🐢👔
男女老少	男女老少 👨👩👴👶
三五成群	三五成群 👌✋🍊👗
三人成虎	三人成虎 👌🚶🍊🐅
笑口常开	笑口常开 😄👄🎤👐
手舞足蹈	手舞足蹈 ✋💃👞🙏 🕺🏻
舍己救人	舍己救人 🎯🐣🚑🙎 🐍🐔9⃣👦
无孔不入	无孔不入 🈚⭕🙅🍼
原原本本	原原本本 ⚪⚪📒📒
拨云见日	拨云见日 🍍☁🚀☀ 🍍☁️🚀🌞
指与世人	指与世人 😭😃🙅🏡思是
授受不亲	授受不亲 ✋✋❌😙
辣鸡	辣鸡 🌶️🐔 🥬🐓 🙃 🚮 🚯
妖魔鬼怪	妖魔鬼怪 👿👻💀👽
心照不宣	心照不宣 ♥💡👣📢 ❤️🌞✋📣
悲喜交加	悲喜交加 🏆🎎🙅🏩
眉目传情	眉目传情 🌹👀👄💏
猪朋狗友	猪朋狗友 🐷👫🐶👫
指腹为婚	指腹为婚 💅👨☎🎎
一拍即合	一拍即合 ☝👏🐔👘
骑虎难下	骑虎难下 🇨🇳🐯👦👇
鸡口牛后	鸡口牛后 🐓👄🐄🐵
一鸣惊人	一鸣惊人 👔🎷😃👵
掩人耳目	掩人耳目 🚬👸👂👀
刻舟求剑	刻舟求剑 🔪🚣🏀🚀
犀牛望月	犀牛望月 🌇🐂🔭🌙
一见钟情	一见钟情 ☝️🚀🀄️👫 💘
吉人天相	吉人天相 🐓👮🌞🐘
心心相印	心心相印 ❤️💜🐘👣 💕 💞 💕
吹牛拍马	吹牛拍马 🎷🐄🎬🐎
群龙无首	群龙无首 👗🐲💃👋
鸡飞狗跳	鸡飞狗跳 🐔🚁🐶💃
吉凶祸福	吉凶祸福 🐓🐻🐰🎽
欢天喜地	欢天喜地 😃🌞💓🚇
惊天动地	惊天动地 😨🌞💓🚇
望穿秋水	望穿秋水 🔭🚢🏀🍵
掩耳盗铃	掩耳盗铃 🚬👂👻🔔
鸡犬升天	鸡犬升天 🐣🐺🎆🌈
携手并肩	携手并肩 👠👋🍦✂️
守株待兔	守株待兔 ✋🐗🎩🐰
笔走龙蛇	笔走龙蛇 ✒️👣🐲🐍
千真万确	千真万确 📝️💉卍🐦
一锤定音	一锤定音 ☝️🔨📌🎵
鸡鸣而起	鸡鸣而起 🐓📢👂🚩
笔头生花	笔头生花 ✒️👶🎆🌹
嘴甜心苦	嘴甜心苦 👄🍫💜💦
零零星星	零零星星 🔔🔔🌠✳️
指桑骂槐	指桑骂槐 👉🐓👄🐕
移花接木	移花接木 📏🌹🍶👀
海啸山崩	海啸山崩 🌊😄🌋💥
人声鼎沸	人声鼎沸 👶🔊🎱👬
全心全意	全心全意 👊💜👊☝️
衣食父母	衣食父母 👕🍚👨👩
众望所归	众望所归 🀄️🔭🔒🐢
星罗棋布	星罗棋布 ⭐️🍍🚩🎽
前因后果	前因后果 💰🎤🐒💃
书香门第	书香门第 📖🍌🚪👬
飞鸟依人	飞鸟依人 ✈️🐦☝️👸
耳目一新	耳目一新 👂👀👕💚
怒火中烧	怒火中烧 💢🔥🀄🔥
面无人色	面无人色 🍜🈚🙎😍
渔翁之利	渔翁之利 🎏👴🍹💪
坐吃山空	坐吃山空 💺🍚🗻⚪
九流三教	九流三教 9⃣🕕3⃣👣
各就各位	各就各位 🈹🍺🈹📞
不吹不黑	不吹不黑 🙅‍🌬🙅‍🌑
有一说一	有一说一 🈶1⃣🗣1⃣
18禁	18禁 🔞
十八禁	十八禁 🔞
a	a あ ア ā á ă à Å ⓐ Ⓐ 🄰 🅐 🅰 ⒜ 🄐 🇦 𝒶 𝒜 𝓪 𝓐 𝔞 𝔄 𝖆 𝕬 a̶̶ A̶ 𝚊 𝙰 𝕒 𝔸 ȁ â ȃ ȧ ä ã ₐ ª ⱥ ꬰ ả ą ạ ḁ ẚ ấ ầ ẫ ẩ ắ ằ ẵ ẳ ǡ ǟ ǻ ậ ặ ᶏ ɐ ᵄ ɑ ᵅ ᶐ ɒ ᴀ Ɒ
aa	aa ꜳ
AB型血	AB型血 🆎
ae	ae æ ǣ ǽ
Afghanistan	Afghanistan 🇦🇫
African	African 🇨🇫
Åland	Åland 🇦🇽
Albania	Albania 🇦🇱
Algeria	Algeria 🇩🇿
alpha	alpha Α 𝛢 α 𝛼
Andorra	Andorra 🇦🇩
Angola	Angola 🇦🇴
Anguilla	Anguilla 🇦🇮
Antarctica	Antarctica 🇦🇶
Antigua	Antigua 🇦🇬
ao	ao ꜵ Ꜵ
Arab	Arab 🇦🇪
Argentina	Argentina 🇦🇷
Armenia	Armenia 🇦🇲
Aruba	Aruba 🇦🇼
Ascension	Ascension 🇦🇨
at	at @
atled	atled ∇
ATM	ATM 🏧
au	au ꜷ Ꜷ
Australia	Australia 🇦🇺
Austria	Austria 🇦🇹
av	av ꜹ ꜻ
ay	ay ꜽ Ꜽ
Azerbaijan	Azerbaijan 🇦🇿
A型血	A型血 🅰
b	b ⓑ Ⓑ 🄱 🅑 🅱 ⒝ 🄑 🇧 𝒷 ℬ 𝓫 𝓑 𝔟 𝔅 𝖇 𝕭 b̶ 𝚋 𝙱 𝕓 𝔹 ḃ ḅ ƀ ƃ ḇ ɓ ᵬ ᶀ ꞗ ʙ ᴃ
ba	ba ば バ
Bahamas	Bahamas 🇧🇸
Bahrain	Bahrain 🇧🇭
Bangladesh	Bangladesh 🇧🇩
Barbados	Barbados 🇧🇧
Barbuda	Barbuda 🇦🇬
be	be べ ベ
Belarus	Belarus 🇧🇾
Belgium	Belgium 🇧🇪
Belize	Belize 🇧🇿
Benin	Benin 🇧🇯
benzene	benzene ⌬ ⏣
Bermuda	Bermuda 🇧🇲
beta	beta Β 𝛣 𝛽
Bhutan	Bhutan 🇧🇹
bi	bi び ビ
bikini	bikini 👙
bo	bo ぼ ボ
Bolivia	Bolivia 🇧🇴
Bosnia	Bosnia 🇧🇦
Botswana	Botswana 🇧🇼
Bouvet	Bouvet 🇧🇻
BP机	BP机 📟
Brazil	Brazil 🇧🇷
Brunei	Brunei 🇧🇳
bu	bu ぶ ブ
Bulgaria	Bulgaria 🇧🇬
BurkinaFaso	BurkinaFaso 🇧🇫
Burundi	Burundi 🇧🇮
bya	bya びゃ ビャ
byo	byo びょ ビョ
byu	byu びゅ ビュ
B型血	B型血 🅱
c	c ℃ ⓒ Ⓒ 🄲 🅒 🅲 ⒞ 🄒 🇨 𝒸 𝒞 𝓬 𝓒 𝔠 ℭ 𝖈 𝕮 c̶ 𝚌 𝙲 𝕔 ℂ ç ć č ĉ ċ ȼ ꞓ ƈ ḉ ɕ ꜿ ᴄ
Cambodia	Cambodia 🇰🇭
Cameroon	Cameroon 🇨🇲
Canada	Canada 🇨🇦
Caribbean	Caribbean 🇧🇶
ce	ce せﾟ セﾟ
Ceuta	Ceuta 🇪🇦
cha	cha ちゃ チャ
Chad	Chad 🇹🇩
che	che ちぇ チェ
chi	chi Χ 𝛸 𝜒 ち チ
Chile	Chile 🇨🇱
China	China 🇨🇳
cho	cho ちょ チョ
Christmas	Christmas 🇨🇽
chu	chu ちゅ チュ
Clipperton	Clipperton 🇨🇵
Cocos	Cocos 🇨🇨
Colombia	Colombia 🇨🇴
Congo	Congo 🇨🇩 🇨🇬
Cook	Cook 🇨🇰
Croatia	Croatia 🇭🇷
Cuba	Cuba 🇨🇺
Curaçao	Curaçao 🇨🇼
Cyprus	Cyprus 🇨🇾
Czech	Czech 🇨🇿
d	d ⓓ Ⓓ 🄳 🅓 🅳 ⒟ 🄓 🇩 𝒹 𝒟 𝓭 𝓓 𝔡 𝔇 𝖉 𝕯 d̶ 𝚍 𝙳 𝕕 𝔻 ď ḋ đ ƌ ᵭ ḑ ḓ ḏ ḍ ɖ ɗ ᶑ ᶁ ð ꝱ ʤ ʣ ʥ ȡ ƍ ǳ ǆ ẟ ᴅ ᴆ
da	da だ ダ
dagger	dagger † ‡ 🗡
db	db ȸ
de	de で デ
del	del ∇
delta	delta Δ 𝛥 𝛿
Denmark	Denmark 🇩🇰
di	di でぃ ディ
Djibouti	Djibouti 🇩🇯
DNA	DNA 🧬
do	do ど ド
Dominica	Dominica 🇩🇲 🇩🇴
du	du どぅ ドゥ
dya	dya でゃ デャ
dyo	dyo でょ デョ
dyu	dyu でゅ デュ
e	e え エ ē é ĕ è ⓔ Ⓔ 🄴 🅔 🅴 ⒠ 🄔 🇪 ℯ 𝓮 𝓔 𝔢 𝔈 𝖊 𝕰 e̶ 𝚎 𝙴 𝕖 𝔼 ȅ ê ȇ ė ë ẽ ₑ ɇ ꬳ ẻ ȩ ę ḙ ẹ ḛ ḗ ḕ ế ề ễ ể ḝ ệ ᶒ ɘ ə ɚ ᶕ ɛ ᶓ ɜ ᵌ ɝ ᶔ ɞ ʚ ǝ ₔ ȝ ⱸ ᴇ ⱻ
Ecuador	Ecuador 🇪🇨
Egypt	Egypt 🇪🇬
epsilon	epsilon Ε 𝛦 𝜀 𝜖
Eritrea	Eritrea 🇪🇷
Estonia	Estonia 🇪🇪
eta	eta Η 𝛨 𝜂
Ethiopia	Ethiopia 🇪🇹
f	f ℉ ⓕ Ⓕ 🄵 🅕 🅵 ⒡ 🄕 🇫 𝒻 ℱ 𝓯 𝓕 𝔣 𝔉 𝖋 𝕱 f̶ 𝚏 𝙵 𝕗 𝔽 ḟ ƒ ᵮ ᶂ ꞙ ꜰ ꟻ
fa	fa ふぁ ファ
Falkland	Falkland 🇫🇰
Faroe	Faroe 🇫🇴
fe	fe ふぇ フェ
ff	ff ﬀ
ffi	ffi ﬃ
ffl	ffl ﬄ
fi	fi ﬁ ふぃ フィ
Fiji	Fiji 🇫🇯
Finland	Finland 🇫🇮
fl	fl ﬂ
fn	fn ʩ
fo	fo ふぉ フォ
France	France 🇫🇷
fu	fu ふ フ
fya	fya ふゃ フャ
fyo	fyo ふょ フョ
fyu	fyu ふゅ フュ
g	g ⓖ Ⓖ 🄶 🅖 🅶 ⒢ 🄖 🇬 ℊ 𝒢 𝓰 𝓖 𝔤 𝔊 𝖌 𝕲 g̶ 𝚐 𝙶 𝕘 𝔾 ḡ ǵ ǧ ĝ ğ ġ ǥ ꞡ ģ ɠ ᵷ ᶃ ɡ ꬶ ɣ ɤ ᵹ ʛ
ga	ga が ガ
Gabon	Gabon 🇬🇦
Gambia	Gambia 🇬🇲
gamma	gamma Γ 𝛤 𝛾
ge	ge げ ゲ
Georgia	Georgia 🇬🇪
Germany	Germany 🇩🇪
Ghana	Ghana 🇬🇭
gi	gi ぎ ギ
Gibraltar	Gibraltar 🇬🇮
go	go ご ゴ
Greece	Greece 🇬🇷
Greenland	Greenland 🇬🇱
Grenada	Grenada 🇬🇩
gu	gu ぐ グ
Guam	Guam 🇬🇺
Guatemala	Guatemala 🇬🇹
Guinea	Guinea 🇬🇳
gwa	gwa ぐゎ グヮ
gya	gya ぎゃ ギャ
gyo	gyo ぎょ ギョ
gyu	gyu ぎゅ ギュ
h	h ⓗ Ⓗ 🄷 🅗 🅷 ⒣ 🄗 🇭 ℏ ħ 𝒽 ℋ 𝓱 𝓗 𝔥 ℌ 𝖍 𝕳 h̶ 𝚑 𝙷 𝕙 ℍ ĥ ȟ ḣ ḧ ͪ ɦ ꜧ ꭜ ɧ ḩ ẖ ḫ ḥ ⱨ ɥ ʮ ʯ ⱶ ʜ Ɥ
ha	ha は ハ
Haiti	Haiti 🇭🇹
Halloween	Halloween 😨 😰 😱 🤡 😈 👿 👹 👺 💀 ☠ 👻 👽 👾 🤖 🧙‍ 🧚‍ 🧛‍ 🧜‍ 🧝‍ 🧞‍ 🧟‍ 🕴 💚 🖤 🦄 🦇 🦉 🕷 🕸 🥀 🍫 🍬 🍭 🏚 🌃 🛸 🌕 🌚 🌩 ⚡ 🎃 🔮 🎭 🕯 🗡 ⛓ ⚰ ⚱
hbar	hbar ℏ ħ
he	he へ ヘ
Herzegovina	Herzegovina 🇧🇦
hi	hi ひ ヒ
ho	ho ほ ホ
Honduras	Honduras 🇭🇳
hu	hu ほぅ ホゥ
Hungary	Hungary 🇭🇺
hv	hv ƕ
hya	hya ひゃ ヒャ
hyo	hyo ひょ ヒョ
hyu	hyu ひゅ ヒュ
i	i い イ ī í ĭ ì ⓘ Ⓘ 🄸 🅘 🅸 ⒤ 🄘 🇮 𝒾 ℐ 𝓲 𝓘 𝔦 ℑ 𝖎 𝕴 i̶ 𝚒 𝙸 𝕚 𝕀 ȉ î ȋ ï ĩ ᵢ ı ɨ ỉ į ị ḭ ᴉ ḯ ᶖ ɩ ᵼ ɪ ᵻ ꟾ
Iceland	Iceland 🇮🇸
ij	ij ĳ
India	India 🇮🇳
Indonesia	Indonesia 🇮🇩
iota	iota Ι 𝛪 𝜄
Iran	Iran 🇮🇷
Iraq	Iraq 🇮🇶
Ireland	Ireland 🇮🇪
Israel	Israel 🇮🇱
Italy	Italy 🇮🇹
j	j ⓙ Ⓙ 🄹 🅙 🅹 ⒥ 🄙 🇯 𝒿 𝒥 𝓳 𝓙 𝔧 𝔍 𝖏 𝕵 j̶ 𝚓 𝙹 𝕛 𝕁 ĵ ǰ ⱼ ɉ ȷ ɟ ʄ ʝ ᴊ Ʝ
ja	ja じゃ ジャ
Jamaica	Jamaica 🇯🇲
Japan	Japan 🇯🇵 🗾 🎌
je	je じぇ ジェ
ji	ji じ ジ ぢ ヂ
jo	jo じょ ジョ
Jordan	Jordan 🇯🇴
ju	ju じゅ ジュ
k	k ⓚ Ⓚ 🄺 🅚 🅺 ⒦ 🄚 🇰 𝓀 𝒦 𝓴 𝓚 𝔨 𝔎 𝖐 𝕶 k̶ 𝚔 𝙺 𝕜 𝕂 ḱ ǩ ₖ ꝁ ꝃ ꞣ ꝅ ķ ḵ ḳ ƙ ᶄ ⱪ ʞ ĸ ᴋ Ʞ
ka	ka か カ
kappa	kappa Κ 𝛫 𝜅 ϰ 𝜘
Kazakhstan	Kazakhstan 🇰🇿
ke	ke け ケ
Kenya	Kenya 🇰🇪
ki	ki き キ
Kiribati	Kiribati 🇰🇮
ko	ko こ コ
Korea	Korea 🇰🇵 🇰🇷
Kosovo	Kosovo 🇽🇰
ku	ku く ク
Kuwait	Kuwait 🇰🇼
kwa	kwa くぁ クァ くゎ クヮ
kwe	kwe くぇ クェ
kwi	kwi くぃ クィ
kwo	kwo くぉ クォ
kwya	kwya くゃ クャ
kwyo	kwyo くょ クョ
kwyu	kwyu くゅ クュ
kya	kya きゃ キャ
kyo	kyo きょ キョ
Kyrgyzstan	Kyrgyzstan 🇰🇬
kyu	kyu きゅ キュ
l	l ⓛ Ⓛ 🄻 🅛 🅻 ⒧ 🄛 🇱 𝓁 ℒ 𝓵 𝓛 𝔩 𝔏 𝖑 𝕷 l̶ 𝚕 𝙻 𝕝 𝕃 ĺ ł ꝉ ƚ ⱡ ɫ ꭞ ɬ ľ ļ ḻ ḽ ḷ ŀ ꝲ ƛ ᶅ ɭ ḹ ȴ ꝇ ʟ ᴌ
la	la らﾟ ラﾟ
lambda	lambda Λ 𝛬 𝜆
Latvia	Latvia 🇱🇻
le	le れﾟ レﾟ
Lebanon	Lebanon 🇱🇧
Lesotho	Lesotho 🇱🇸
li	li りﾟ リﾟ
Liberia	Liberia 🇱🇷
Libya	Libya 🇱🇾
Liechtenstein	Liechtenstein 🇱🇮
Lithuania	Lithuania 🇱🇹
lj	lj ǉ
ll	ll ỻ
lo	lo ろﾟ ロﾟ
ls	ls ʪ
lu	lu るﾟ ルﾟ
Luxemburg	Luxemburg 🇱🇺
lya	lya りﾟゃ リﾟャ
lyo	lyo りﾟょ リﾟョ
lyu	lyu りﾟゅ リﾟュ
lz	lz ʫ ɮ
m	m ⓜ Ⓜ 🄼 🅜 🅼 ⒨ 🄜 🇲 𝓂 ℳ 𝓶 𝓜 𝔪 𝔐 𝖒 𝕸 m̶ 𝚖 𝙼 𝕞 𝕄 ḿ ṁ ₘ ṃ ᵯ ɱ ꬺ ᶆ ꝳ ɯ ɰ ᴟ ᴍ ꟽ ꟿ
ma	ma ま マ
Macau	Macau 🇲🇴
Macedonia	Macedonia 🇲🇰
Madagascar	Madagascar 🇲🇬
Malawi	Malawi 🇲🇼
Malaysia	Malaysia 🇲🇾
Maldives	Maldives 🇲🇻
Mali	Mali 🇲🇱
Malta	Malta 🇲🇹
Mauritania	Mauritania 🇲🇷
Mauritius	Mauritius 🇲🇺
me	me め メ
Melilla	Melilla 🇪🇦
Mexico	Mexico 🇲🇽
mi	mi み ミ
mo	mo も モ
Moldova	Moldova 🇲🇩
Monaco	Monaco 🇲🇨
Mongolia	Mongolia 🇲🇳
Montenegro	Montenegro 🇲🇪
Morocco	Morocco 🇲🇦
Mozambique	Mozambique 🇲🇿
mu	mu Μ 𝛭 𝜇 む ム
mya	mya みゃ ミャ
Myanmar	Myanmar 🇲🇲
myo	myo みょ ミョ
myu	myu みゅ ミュ
n	n ん ン ⓝ Ⓝ 🄽 🅝 🅽 ⒩ 🄝 🇳 𝓃 𝒩 𝓷 𝓝 𝔫 𝔑 𝖓 𝕹 n̶ 𝚗 𝙽 𝕟 ℕ ń ň ǹ ṅ ñ ₙ ⁿ ɲ ɳ ȵ ƞ ŋ ꬻ ꝴ ŉ ꞥ ņ ṉ ṋ ṇ ᵰ ꞑ ᶇ ᴻ
na	na な ナ
nabla	nabla ∇
Namibia	Namibia 🇳🇦
Nauru	Nauru 🇳🇷
ne	ne ね ネ
Nepal	Nepal 🇳🇵
Netherlands	Netherlands 🇳🇱
nga	nga かﾟ カﾟ
nge	nge けﾟ ケﾟ
ngi	ngi きﾟ キﾟ
ngo	ngo こﾟ コﾟ
ngu	ngu くﾟ クﾟ
ngwa	ngwa くﾟゎ クﾟヮ
ngya	ngya きﾟゃ キﾟャ
ngyo	ngyo きﾟょ キﾟョ
ngyu	ngyu きﾟゅ キﾟュ
ni	ni に ニ
Nicaragua	Nicaragua 🇳🇮
Niger	Niger 🇳🇪
Nigeria	Nigeria 🇳🇬
nj	nj ǌ
no	no の ノ ❌ ✖ ✗ ✘ × ☒ ❎ ❌ 🙅‍♂ 🙅 🙅‍♀ 🆖 🙅🏻‍♂ 🙅🏼‍♂ 🙅🏽‍♂ 🙅🏾‍♂ 🙅🏿‍♂ 🙅🏻 🙅🏼 🙅🏽 🙅🏾 🙅🏿 🙅🏻‍♀ 🙅🏼‍♀ 🙅🏽‍♀ 🙅🏾‍♀ 🙅🏿‍♀
Norway	Norway 🇳🇴
nu	nu Ν 𝛮 𝜈 ぬ ヌ
number	number №
nya	nya にゃ ニャ
nyo	nyo にょ ニョ
nyu	nyu にゅ ニュ
o	o お オ ō ó ŏ ò ⓞ Ⓞ 🄾 🅞 🅾 ⒪ 🄞 🇴 ℴ 𝒪 𝓸 𝓞 𝔬 𝔒 𝖔 𝕺 o̶ 𝚘 𝙾 𝕠 𝕆 ô Ø ö ő ȯ õ ₒ º ɔ ᶗ ꬿ ǫ ọ ơ ɵ ᴑ ᴒ ᴓ ꝋ ꝍ ṓ ṑ ố ồ ỗ ổ ȱ ȫ ȭ ṏ ộ ǭ ǿ ớ ờ ỡ ở ợ ɷ ⱺ ᴖ ᴗ ᴏ ᴐ
oe	oe œ ᴔ ɶ
oi	oi ƣ
OK	OK 🆗 🙆‍♂ 🙆 🙆‍♀ 👌 👍 🙆🏻‍♂ 🙆🏼‍♂ 🙆🏽‍♂ 🙆🏾‍♂ 🙆🏿‍♂ 🙆🏻 🙆🏼 🙆🏽 🙆🏾 🙆🏿 🙆🏻‍♀ 🙆🏼‍♀ 🙆🏽‍♀ 🙆🏾‍♀ 🙆🏿‍♀ 👌🏻 👌🏼 👌🏽 👌🏾 👌🏿 👍🏻 👍🏼 👍🏽 👍🏾 👍🏿
Oman	Oman 🇴🇲
omega	omega Ω 𝛺 𝜔
omicron	omicron Ο 𝛰 𝜊
oo	oo ꝏ
ou	ou ȣ
O型血	O型血 🅾 🅾️
p	p ⓟ Ⓟ ℗ 🄿 🅟 🅿 ⒫ 🄟 🇵 𝓅 𝒫 𝓹 𝓟 𝔭 𝔓 𝖕 𝕻 p̶ 𝚙 𝙿 𝕡 ℙ ṕ ṗ ᵽ ꝑ ᵱ ƥ ᶈ ꝓ ꝕ ɸ ⱷ ᴘ ꟼ
pa	pa ぱ パ
Pakistan	Pakistan 🇵🇰
Panama	Panama 🇵🇦
Paraguay	Paraguay 🇵🇾
partial	partial ∂ 𝛛 𝜕 𝝏
pe	pe ぺ ペ
Peru	Peru 🇵🇪
pH	pH ㏗
phi	phi Φ 𝛷 𝜑 ϕ 𝜙
Philippines	Philippines 🇵🇭
pi	pi Π 𝛱 𝜋 ϖ 𝜛 ぴ ピ
po	po ぽ ポ
Poland	Poland 🇵🇱
Portugal	Portugal 🇵🇹
ppm	ppm ㏙
psi	psi Ψ 𝛹 𝜓
pu	pu ぷ プ
pya	pya ぴゃ ピャ
pyo	pyo ぴょ ピョ
pyu	pyu ぴゅ ピュ
q	q ー ⓠ Ⓠ 🅀 🅠 🆀 ⒬ 🄠 🇶 𝓆 𝒬 𝓺 𝓠 𝔮 𝔔 𝖖 𝕼 q̶ 𝚚 𝚀 𝕢 ℚ ɋ ꝗ ꝙ ʠ
Qatar	Qatar 🇶🇦
qp	qp ȹ
r	r ʀ ⓡ Ⓡ 🅁 🅡 🆁 ⒭ 🄡 🇷 𝓇 ℛ 𝓻 𝓡 𝔯 ℜ 𝖗 𝕽 r̶ 𝚛 𝚁 𝕣 ℝ ŕ ř ȑ ȓ ṙ ᵣ ɍ ꞧ ᵲ ŗ ṟ ṛ ṝ ᵳ ɽ ᶉ ꭇ ꝵ ɹ ɺ ɻ ⱹ ɼ ɾ ɿ ꝛ ꝝ ᴙ ꝶ ʶ
ra	ra ら ラ
re	re れ レ
rho	rho Ρ 𝛲 𝜌 ϱ 𝜚
ri	ri り リ
ro	ro ろ ロ
Romania	Romania 🇷🇴
ru	ru る ル
Russia	Russia 🇷🇺
Rwanda	Rwanda 🇷🇼
rya	rya りゃ リャ
ryo	ryo りょ リョ
ryu	ryu りゅ リュ
s	s $ ⓢ Ⓢ 🅂 🅢 🆂 ⒮ 🄢 🇸 𝓈 𝒮 𝓼 𝓢 𝔰 𝔖 𝖘 𝕾 s̶ 𝚜 𝚂 𝕤 𝕊 ś ŝ š ṡ ʂ ᵴ ꞩ ᶊ ş ṣ ș ȿ ṧ ṩ ʃ ʆ ᶘ ʅ ƪ ß ſ ẛ ẜ ẝ ꜱ
sa	sa さ サ
Sahara	Sahara 🇪🇭
Samoa	Samoa 🇼🇸
se	se せ セ
Senegal	Senegal 🇸🇳
Serbia	Serbia 🇷🇸
sha	sha しゃ シャ
she	she しぇ シェ
shi	shi し シ
sho	sho しょ ショ
shu	shu しゅ シュ
si	si すぃ スィ
sigma	sigma Σ 𝛴 𝜎
Singapore	Singapore 🇸🇬
Slovakia	Slovakia 🇸🇰
Slovenia	Slovenia 🇸🇮
so	so そ ソ
Somalia	Somalia 🇸🇴
Spain	Spain 🇪🇸
su	su す ス
Sudan	Sudan 🇸🇩
Swaziland	Swaziland 🇸🇿
Sweden	Sweden 🇸🇪
Switzerland	Switzerland 🇨🇭
Syria	Syria 🇸🇾
t	t っ ッ ⓣ Ⓣ 🅃 🅣 🆃 ⒯ 🄣 🇹 𝓉 𝒯 𝓽 𝓣 𝔱 𝔗 𝖙 𝕿 t̶ 𝚝 𝚃 𝕥 𝕋 ť ṫ ẗ ₜ ʈ þ ŧ ⱦ ţ ṯ ṱ ṭ ț ƭ ᵵ ƫ ʇ ȶ ꝷ ᴛ Ʇ
ta	ta た タ
Tajikistan	Tajikistan 🇹🇯
Tanzania	Tanzania 🇹🇿
tau	tau Τ 𝛵 𝜏
tc	tc ʨ
te	te て テ
th	th ᵺ
Thailand	Thailand 🇹🇭
theta	theta Θ 𝛩 ϴ 𝛳 𝜃 𝜗
ti	ti てぃ ティ
tm	tm ™
to	to と ト
Togo	Togo 🇹🇬
ts	ts ʦ ʧ
tsa	tsa つぁ ツァ
tse	tse つぇ ツェ
tsi	tsi つぃ ツィ
tso	tso つぉ ツォ
tsu	tsu つ ツ
tu	tu つﾟ ツﾟ とぅ トゥ
Tunisia	Tunisia 🇹🇳
Turkey	Turkey 🇹🇷
Turkmenistan	Turkmenistan 🇹🇲
tya	tya てゃ テャ
tyo	tyo てょ テョ
tyu	tyu てゅ テュ
tz	tz ꜩ
T恤	T恤 👕
T恤衫	T恤衫 👕
u	u う ウ ū ú ŭ ù ü ǖ ǘ ǚ ǜ ⓤ Ⓤ 🅄 🅤 🆄 ⒰ 🄤 🇺 𝓊 𝒰 𝓾 𝓤 𝔲 𝔘 𝖚 𝖀 u̶ 𝚞 𝚄 𝕦 𝕌 ȕ û ȗ ů ũ ᵤ ʉ ủ ų ṷ ụ ṳ ṵ ư ʊ ᵿ ᶙ ứ ừ ữ ử ự ꭒ ꝸ ᴝ ᴞ Ű ᴜ
ue	ue ᵫ
Uganda	Uganda 🇺🇬
Ukraine	Ukraine 🇺🇦
upsilon	upsilon Υ 𝛶 𝜐
Uruguay	Uruguay 🇺🇾
Uzbekistan	Uzbekistan 🇺🇿
v	v ⓥ Ⓥ 🅅 🅥 🆅 ⒱ 🄥 🇻 𝓋 𝒱 𝓿 𝓥 𝔳 𝔙 𝖛 𝖁 v̶ 𝚟 𝚅 𝕧 𝕍 ṽ ᵥ ṿ ꝟ ʋ ᶌ ⱴ ⱱ ỽ ʌ ᴠ
va	va ゔぁ ヴァ
Vatican	Vatican 🇻🇦
ve	ve ゔぇ ヴェ
Venezuela	Venezuela 🇻🇪
vi	vi ゔぃ ヴィ
Vietnam	Vietnam 🇻🇳
vo	vo ゔぉ ヴォ
vs	vs 🆚
vu	vu ゔ ヴ
vy	vy ꝡ
vya	vya ゔゃ ヴャ
vyo	vyo ゔょ ヴョ
vyu	vyu ゔゅ ヴュ
w	w ⓦ Ⓦ 🅆 🅦 🆆 ⒲ 🄦 🇼 𝓌 𝒲 𝔀 𝓦 𝔴 𝔚 𝖜 𝖂 w̶ 𝚠 𝚆 𝕨 𝕎 ẃ ẁ ŵ ẇ ẅ ẘ ẉ ƿ ʍ ⱳ W̊ ᴡ
wa	wa わ ワ
we	we ゑ ヱ
whe	whe うぇ ウェ
whi	whi うぃ ウィ
wi	wi ゐ ヰ
wo	wo を ヲ
ww	ww ʬ
x	x ⓧ Ⓧ 🅇 🅧 🆇 ⒳ 🄧 🇽 𝓍 𝒳 𝔁 𝓧 𝔵 𝔛 𝖝 𝖃 x̶ 𝚡 𝚇 𝕩 𝕏 ẋ ẍ ᶍ ₓ ꭖ
xi	xi Ξ 𝛯 𝜉
y	y ⓨ Ⓨ 🅈 🅨 🆈 ⒴ 🄨 🇾 𝓎 𝒴 𝔂 𝓨 𝔶 𝔜 𝖞 𝖄 y̶ 𝚢 𝚈 𝕪 𝕐 ȳ ý ỳ ŷ ẏ ÿ ẙ ỹ ɏ ỷ ỵ ƴ ʎ ỿ ꭚ ʏ
ya	ya や ヤ
Yemen	Yemen 🇾🇪
yo	yo よ ヨ
yu	yu ゆ ユ
z	z ⓩ Ⓩ 🅉 🅩 🆉 ⒵ 🄩 🇿 𝓏 𝒵 𝔃 𝓩 𝔷 ℨ 𝖟 𝖅 z̶ 𝚣 𝚉 𝕫 ℤ ź ž ẑ ż ʐ ʑ ƶ ẕ ẓ ᵶ ȥ ⱬ ᶎ ʒ ǯ ʓ ƹ ƺ ᶚ θ ᶿ ɀ ꝣ ᴢ ᴣ
za	za ざ ザ
Zambia	Zambia 🇿🇲
ze	ze ぜ ゼ
zeta	zeta Ζ 𝛧 𝜁
zi	zi ずぃ ズィ
Zimbabwe	Zimbabwe 🇿🇼
zo	zo ぞ ゾ
zu	zu ず ズ づ ヅ
阿尔巴尼亚	阿尔巴尼亚 🇦🇱
阿尔及利亚	阿尔及利亚 🇩🇿
阿爾巴尼亞	阿爾巴尼亞 🇦🇱
阿爾及利亞	阿爾及利亞 🇩🇿
阿富汗	阿富汗 🇦🇫
阿根廷	阿根廷 🇦🇷
阿公	阿公 👴 👴🏻 👴🏻
阿拉伯	阿拉伯 ☪ 👳 🧔🏻 🧕🏻 ☪️ 🧕🏾
阿拉伯联合酋长国	阿拉伯联合酋长国 🇦🇪
阿拉伯聯合大公國	阿拉伯聯合大公國 🇦🇪
阿拉伯男人	阿拉伯男人 🧔🏻
阿拉伯女人	阿拉伯女人 🧕🏻 🧕🏾
阿拉丁灯神	阿拉丁灯神 🧞‍♀ 🧞‍♂ 🧞
阿拉丁燈神	阿拉丁燈神 🧞‍♀ 🧞‍♂ 🧞
阿兰群岛	阿兰群岛 🇦🇽
阿联	阿联 🇦🇪
阿联酋	阿联酋 🇦🇪
阿聯	阿聯 🇦🇪
阿聯酋	阿聯酋 🇦🇪
阿鲁巴	阿鲁巴 🇦🇼
阿鲁巴岛	阿鲁巴岛 🇦🇼
阿魯巴	阿魯巴 🇦🇼
阿曼	阿曼 🇴🇲
阿婆	阿婆 👵 👵🏻 👵🏻
阿塞拜彊	阿塞拜彊 🇦🇿
阿塞拜疆	阿塞拜疆 🇦🇿
阿森松	阿森松 🇸🇭
阿森松岛	阿森松岛 🇦🇨
阿爷	阿爷 👴 👴🏻 👴🏻
阿爺	阿爺 👴 👴🏻 👴🏻
啊	啊 😟 😥 😿 🤨 😢 😥 😿 🤨
啊嚏	啊嚏 🤧
哀悼	哀悼 💮
埃	埃 Å
埃及	埃及 🇪🇬
埃塞俄比亚	埃塞俄比亚 🇪🇹
埃塞俄比亞	埃塞俄比亞 🇪🇹
唉	唉 😔 😪 😪 😮‍💨
爱	爱 👫 👬 👭 💑 👨‍❤‍👨 👩‍❤‍👩 😍 😘 🥰 😻 🤟 🤟🏻 🤟🏼 🤟🏽 🤟🏾 🤟🏿 ❤ 💓 💗 ❤️️ 🥰
爱尔兰	爱尔兰 🇮🇪
爱你	爱你 😍 😘 🥰 😻 🤟 🤟🏻 🤟🏼 🤟🏽 🤟🏾 🤟🏿 😚 😽 🤟🏻 🥰
爱情	爱情 👫 👬 👭 💑 👨‍❤‍👨 👩‍❤‍👩 💓 💑🏻
爱情宾馆	爱情宾馆 🏩
爱情旅馆	爱情旅馆 🏩
爱沙尼亚	爱沙尼亚 🇪🇪
爱心	爱心 ❤ 💗 💗 🫶🏻
爱心礼物	爱心礼物 💝
爱意	爱意 💟
愛	愛 ❤ 💓 💗 😍 😘 🥰 ❤️️ 🥰
愛爾蘭	愛爾蘭 🇮🇪
愛你	愛你 😍 😘 😚 😽 🤟🏻 🥰 🤟🏻 🥰
愛情	愛情 💑 💓 💑🏻
愛情賓館	愛情賓館 🏩
愛情旅館	愛情旅館 🏩
愛沙尼亞	愛沙尼亞 🇪🇪
愛心	愛心 ❤ 💗 💗 🫶🏻
愛心禮物	愛心禮物 💝
愛意	愛意 💟
安	安 ㎀ ㎁ ㎂ ㎃ ㎄ 🉃
安道尔	安道尔 🇦🇩
安道尔共和国	安道尔共和国 🇦🇩
安道爾	安道爾 🇦🇩
安道爾共和國	安道爾共和國 🇦🇩
安地卡及巴布达	安地卡及巴布达 🇦🇬
安地卡及巴布達	安地卡及巴布達 🇦🇬
安哥拉	安哥拉 🇦🇴
安圭拉	安圭拉 🇦🇮
安圭拉岛	安圭拉岛 🇦🇮
安检	安检 🛂 🛃 🛄 🛅
安静	安静 😯 🤐 🤫 🤭 🙊 🤫
安靜	安靜 🤫
安培	安培 ㎀ ㎁ ㎂ ㎃ ㎄
安全	安全 🔐
安全帽	安全帽 ⛑ ⛑️
安提瓜和巴布达	安提瓜和巴布达 🇦🇬
安提瓜和巴布達	安提瓜和巴布達 🇦🇬
安慰	安慰 😌 🤗 🤗
安心	安心 😌
安逸	安逸 😌
唵	唵 🕉 🕉️
按摩	按摩 💆‍♂ 💆‍ 💆‍♀ 💆🏻‍♂ 💆🏼‍♂ 💆🏽‍♂ 💆🏾‍♂ 💆🏿‍♂ 💆🏻 💆🏼 💆🏽 💆🏾 💆🏿 💆🏻‍♀ 💆🏼‍♀ 💆🏽‍♀ 💆🏾‍♀ 💆🏿‍♀ 💆 💆🏻
按摩女	按摩女 💆🏻‍♀ 💆🏻‍♀️
按摩师	按摩师 💆🏻‍♂ 💆🏻
按摩師	按摩師 💆🏻‍♂ 💆🏻
按钮	按钮 🅰 🆎 🅱 🆑 🆒 🆓 ℹ 🆔 Ⓜ 🆕 🆖 🅾 🆗 🅿 🆘 🆙 🆚 🔘
按鈕	按鈕 🔘
暗夜精灵	暗夜精灵 🧝🏻‍♀ 🧝🏻‍♂ 🧝🏻
暗夜精靈	暗夜精靈 🧝🏻‍♀ 🧝🏻‍♂ 🧝🏻
奥地利	奥地利 🇦🇹
奥兰群岛	奥兰群岛 🇦🇽
奧地利	奧地利 🇦🇹
奧蘭群島	奧蘭群島 🇦🇽
澳大利亚	澳大利亚 🇦🇺
澳大利亞	澳大利亞 🇦🇺
澳门	澳门 🇲🇴
澳門	澳門 🇲🇴
澳洲	澳洲 🌏 🇦🇺 🇦🇺 🌏
八	八 八、 捌 Ⅷ 〨 ⁸ ₈ ⓼ 𝟠 ⒏ 🄉 ㊇ ㈧ 8⃣ 𓃐 8️⃣
八带鱼	八带鱼 🐙
八帶魚	八帶魚 🐙
八点	八点 🕗
八点半	八点半 🕣
八点钟	八点钟 🕗
八點	八點 🕗
八點半	八點半 🕣
八點鐘	八點鐘 🕗
八卦	八卦 ☯ ☰ ☱ ☲ ☳ ☷ ☶ ☵ ☴ 天乾☰ 泽兑☱ 火离☲ 雷震☳ 地坤☷ 山艮☶ 水坎☵ 风巽☴
八角星	八角星 ✳ ✴ ✳️ ✴️
八门	八门 开门 休门 生门 伤门 杜门 景门 死门 惊门
八荣八耻	八荣八耻 社会主义荣辱观 以热爱祖国为荣，以危害祖国为耻；以服务人民为荣，以背离人民为耻；以崇尚科学为荣，以愚昧无知为耻；以辛勤劳动为荣，以好逸恶劳为耻；以团结互助为荣，以损人利己为耻；以诚实守信为荣，以见利忘义为耻；以遵纪守法为荣，以违法乱纪为耻；以艰苦奋斗为荣，以骄奢淫逸为耻。
八爪鱼	八爪鱼 🐙
八爪魚	八爪魚 🐙
巴巴多斯	巴巴多斯 🇧🇧
巴贝多	巴贝多 🇧🇧
巴貝多	巴貝多 🇧🇧
巴布亚纽几内亚	巴布亚纽几内亚 🇵🇬
巴布亚新几内亚	巴布亚新几内亚 🇵🇬
巴布亞紐幾內亞	巴布亞紐幾內亞 🇵🇬
巴布亞新幾內亞	巴布亞新幾內亞 🇵🇬
巴哈马	巴哈马 🇧🇸
巴哈馬	巴哈馬 🇧🇸
巴基斯坦	巴基斯坦 🇵🇰
巴拉圭	巴拉圭 🇵🇾
巴勒斯坦	巴勒斯坦 🇵🇸
巴林	巴林 🇧🇭
巴拿马	巴拿马 🇵🇦
巴拿馬	巴拿馬 🇵🇦
巴士	巴士 🚌 🚍 🚎 🚐 🚌
巴士站	巴士站 🚏
巴西	巴西 🇧🇷
粑粑	粑粑 💩
把戏	把戏 🤹🏻‍♀ 🤹🏻‍♂ 🤹🏻
把戲	把戲 🤹🏻‍♀ 🤹🏻‍♂ 🤹🏻
爸	爸 👨 👨🏻 👨🏻
爸爸	爸爸 👨 👨🏻 👨🏻
霸王龙	霸王龙 🦖
霸王龍	霸王龍 🦖
白菜	白菜 🥬
白痴	白痴 🐷
白癡	白癡 🐷
白大褂	白大褂 🥼
白俄罗斯	白俄罗斯 🇧🇾
白俄羅斯	白俄羅斯 🇧🇾
白发	白发 👨🏻‍🦳 👩🏻‍🦳 🧑🏻‍🦳
白髮	白髮 👨🏻‍🦳 👩🏻‍🦳 🧑🏻‍🦳
白饭	白饭 🍚
白飯	白飯 🍚
白方	白方 ◻ ◻️
白花	白花 💮
白老鼠	白老鼠 🐁
白领	白领 👨‍💼 🧑‍💼 👩‍💼 👨🏻‍💼 👨🏼‍💼 👨🏽‍💼 👨🏾‍💼 👨🏿‍💼 🧑🏻‍💼 🧑🏼‍💼 🧑🏽‍💼 🧑🏾‍💼 🧑🏿‍💼 👩🏻‍💼 👩🏼‍💼 👩🏽‍💼 👩🏾‍💼 👩🏿‍💼 🧑🏻‍💼
白領	白領 👨🏻‍💼 👩🏻‍💼 🧑🏻‍💼
白罗斯	白罗斯 🇧🇾
白羅斯	白羅斯 🇧🇾
白目	白目 🙄
白旗	白旗 🏳 🏳️
白人	白人 👨🏼 👩🏼 👱🏼‍♀ 👱🏼 👴🏼 👵🏼 👦🏼 👧🏼 👶🏼 🧓🏼 🧑🏼 👱🏼 🧒🏼 👶🏼
白鼠	白鼠 🐁
白兔	白兔 🐇
白眼	白眼 🙄
白羊座	白羊座 ♈ ♈️
白中有黑	白中有黑 🔳
白种人	白种人 👨🏼 👩🏼 👱🏼‍♀ 👱🏼 👴🏼 👵🏼 👦🏼 👧🏼 👶🏼 🧓🏼 🧑🏼 👱🏼 🧒🏼 👶🏼
白種人	白種人 👨🏼 👩🏼 👱🏼‍♀ 👱🏼 👴🏼 👵🏼 👦🏼 👧🏼 👶🏼 🧓🏼 🧑🏼 👱🏼 🧒🏼 👶🏼
白珠	白珠 ⚪ ⚪️
白子	白子 ⚪ ⚪️
百	百 佰
百点	百点 💯
百點	百點 💯
百分	百分 % ％ 💯
百分比	百分比 ㌫
百货	百货 🏬
百货大楼	百货大楼 🏬
百货公司	百货公司 🏬
百货商店	百货商店 🏬
百貨	百貨 🏬
百貨大樓	百貨大樓 🏬
百貨公司	百貨公司 🏬
百貨商店	百貨商店 🏬
百家姓	百家姓 赵钱孙李 周吴郑王 冯陈褚卫 蒋沈韩杨 朱秦尤许 何吕施张 孔曹严华 金魏陶姜 戚谢邹喻 柏水窦章 云苏潘葛 奚范彭郎 鲁韦昌马 苗凤花方 俞任袁柳 酆鲍史唐 费廉岑薛 雷贺倪汤 滕殷罗毕 郝邬安常 乐于时傅 皮卞齐康 伍余元卜 顾孟平黄 和穆萧尹 姚邵湛汪 祁毛禹狄 米贝明臧 计伏成戴 谈宋茅庞 熊纪舒屈 项祝董梁 杜阮蓝闵 席季麻强 贾路娄危 江童颜郭 梅盛林刁 钟徐邱骆 高夏蔡田 樊胡凌霍 虞万支柯 昝管卢莫 经房裘缪 干解应宗 丁宣贲邓 郁单杭洪 包诸左石 崔吉钮龚 程嵇邢滑 裴陆荣翁 荀羊於惠 甄曲家封 芮羿储靳 汲邴糜松 井段富巫 乌焦巴弓 牧隗山谷 车侯宓蓬 全郗班仰 秋仲伊宫 宁仇栾暴 甘钭厉戎 祖武符刘 景詹束龙 叶幸司韶 郜黎蓟薄 印宿白怀 蒲邰从鄂 索咸籍赖 卓蔺屠蒙 池乔阴鬱 胥能苍双 闻莘党翟 谭贡劳逄 姬申扶堵 冉宰郦雍 卻璩桑桂 濮牛寿通 边扈燕冀 郏浦尚农 温别庄晏 柴瞿阎充 慕连茹习 宦艾鱼容 向古易慎 戈廖庾终 暨居衡步 都耿满弘 匡国文寇 广禄阙东 欧殳沃利 蔚越夔隆 师巩厍聂 晁勾敖融 冷訾辛阚 那简饶空 曾毋沙乜 养鞠须丰 巢关蒯相 查后荆红 游竺权逯 盖益桓公 万俟司马 上官欧阳 夏侯诸葛 闻人东方 赫连皇甫 尉迟公羊 澹台公冶 宗政濮阳 淳于单于 太叔申屠 公孙仲孙 轩辕令狐 钟离宇文 长孙慕容 鲜于闾丘 司徒司空 丌官司寇 仉督子车 颛孙端木 巫马公西 漆雕乐正 壤驷公良 拓跋夹谷 宰父谷梁 晋楚闫法 汝鄢涂钦 段干百里 东郭南门 呼延归海 羊舌微生 岳帅缑亢 况郈有琴 梁丘左丘 东门西门 商牟佘佴 伯赏南宫 墨哈谯笪 年爱阳佟 第五言福 百家姓终
百慕达	百慕达 🇧🇲
百慕達	百慕達 🇧🇲
百慕大	百慕大 🇧🇲
柏树	柏树 🌳
柏樹	柏樹 🌳
败	败 🉈
拜	拜 🙏 🙏🏻 🙏🏼 🙏🏽 🙏🏾 🙏🏿
拜拜	拜拜 👋 👋🏻 👋🏻
拜金	拜金 🤑
拜托	拜托 🙏 🥺 🥺
拜託	拜託 🙏 🥺 🥺
扳手	扳手 🔧
班主住	班主住 👨🏻‍🏫 👩🏻‍🏫 🧑🏻‍🏫
班卓	班卓 🪕
斑马	斑马 🦓
斑馬	斑馬 🦓
板车	板车 🛴 🛵
板栗	板栗 🌰
板球	板球 🏏
板球棒	板球棒 🏏
板札	板札 🙌 🙌🏻 🙌🏻
版权	版权 © ℗ ©️
版權	版權 © ©️
办公大楼	办公大楼 🏢
办公楼	办公楼 🏢
半	半 :30
半身像	半身像 👤
半月	半月 🌓
辦公大樓	辦公大樓 🏢
辦公樓	辦公樓 🏢
扮鬼脸	扮鬼脸 😜
扮鬼臉	扮鬼臉 😜
扮酷	扮酷 😎
绑上缎带的心	绑上缎带的心 💝
綁上緞帶的心	綁上緞帶的心 💝
棒	棒 👍 👍🏻 👍🏼 👍🏽 👍🏾 👍🏿 💯 😺 🤩 👍🏻 💯 🤩
棒棒糖	棒棒糖 🍭
棒呆	棒呆 🤩
棒球	棒球 ⚾ ⚾️
傍晚	傍晚 🌆 🌇 🌆
包	包 👜 👝 👛 👝 👛 👜 💼 🧳 🎒
包谷	包谷 🌽
包穀	包穀 🌽
包裹	包裹 📦
包含	包含 ⊂ ⊃ ⊆ ⊇
包米	包米 🌽
包头巾	包头巾 👳
包头巾的男人	包头巾的男人 👳
包頭巾	包頭巾 👳
包頭巾的男人	包頭巾的男人 👳
包装	包装 📦
包装盒	包装盒 🎁
包裝盒	包裝盒 🎁
苞米	苞米 🌽
薄饼	薄饼 🍕 🥞 🍕 🥞 🫓
薄餅	薄餅 🍕 🥞 🍕 🥞 🫓
宝宝	宝宝 👶 🚼
宝贝	宝贝 👶 👶🏻 👶🏻
宝石	宝石 💎 💠
保加利亚	保加利亚 🇧🇬
保加利亞	保加利亞 🇧🇬
保龄	保龄 🎳
保龄球	保龄球 🎳
保齡	保齡 🎳
保齡球	保齡球 🎳
保险丝	保险丝 ⏛
堡垒	堡垒 🏰
堡壘	堡壘 🏰
寶寶	寶寶 👶 🚼
寶貝	寶貝 👶 👶🏻 👶🏻
寶石	寶石 💎 💠
报表	报表 📊
报警	报警 🚔
报刊	报刊 📰
报纸	报纸 📰 🗞 📰
抱抱	抱抱 🤗
抱一抱	抱一抱 🤗
豹	豹 🐆
豹子	豹子 🐆
報表	報表 📊
報警	報警 🚔
報刊	報刊 📰
報紙	報紙 📰
暴风	暴风 🌀
爆米花	爆米花 🍿
爆炸	爆炸 💥 🤯
爆竹	爆竹 🧨
杯式蛋糕	杯式蛋糕 🧁
悲伤	悲伤 😢 😭
悲傷	悲傷 😢 😭
悲痛	悲痛 😢
北	北 🀃
北朝鲜	北朝鲜 🇰🇵
北朝鮮	北朝鮮 🇰🇵
北韩	北韩 🇰🇵
北韓	北韓 🇰🇵
北马里亚纳群岛	北马里亚纳群岛 🇲🇵
北马利安纳群岛	北马利安纳群岛 🇲🇵
北馬里亞納群島	北馬里亞納群島 🇲🇵
北馬利安納群島	北馬利安納群島 🇲🇵
贝	贝 🐚
贝壳	贝壳 🐚
贝类	贝类 🐚
贝里斯	贝里斯 🇧🇿
贝南	贝南 🇧🇯
贝宁	贝宁 🇧🇯
貝	貝 🐚
貝類	貝類 🐚
貝里斯	貝里斯 🇧🇿
貝南	貝南 🇧🇯
貝寧	貝寧 🇧🇯
貝殼	貝殼 🐚
备忘	备忘 📝
备忘录	备忘录 📝 🗒 📇 📋 📕 📝
背包	背包 🎒
背心	背心 🎽
被骗	被骗 💸
被騙	被騙 💸
備忘	備忘 📝
備忘錄	備忘錄 📕 📝 📝
奔马	奔马 🐎
奔馬	奔馬 🐎
奔跑	奔跑 🏃‍♂ 🏃 🏃‍♀ 💨 🏃🏻‍♂ 🏃🏼‍♂ 🏃🏽‍♂ 🏃🏾‍♂ 🏃🏿‍♂ 🏃🏻 🏃🏼 🏃🏽 🏃🏾 🏃🏿 🏃🏻‍♀ 🏃🏼‍♀ 🏃🏽‍♀ 🏃🏾‍♀ 🏃🏿‍♀ 🏃🏻
本	本 🉀
苯	苯 ⌬ ⏣
笨蛋	笨蛋 🐷
鼻	鼻 👃 👃🏻 👃🏼 👃🏽 👃🏾 👃🏿 👃🏻
鼻子	鼻子 👃 👃🏻 👃🏼 👃🏽 👃🏾 👃🏿 👃🏻
匕手	匕手 🗡 🗡️
匕首	匕首 🗡 † ‡
比	比 : / ： 🆚 🆚️
比基尼	比基尼 👙
比利时	比利时 🇧🇪
比利時	比利時 🇧🇪
比例	比例 4:3 16:9
比萨	比萨 🍕
比萨片	比萨片 🍕
比薩	比薩 🍕
比薩片	比薩片 🍕
比赛	比赛 🆚
比賽	比賽 🆚
笔	笔 ✏ ✒ 🖋 🖊
笔电	笔电 💻
笔划	笔划 ㇀ ㇁ ㇂ ㇃ ㇄ ㇅ ㇆ ㇇ ㇈ ㇉ ㇊ ㇋ ㇌ ㇍ ㇎ ㇏ ㇐ ㇑ ㇒ ㇓ ㇔ ㇕ ㇖ ㇗ ㇘ ㇙ ㇚ ㇛ ㇜ ㇝ ㇞ ㇟ ㇠ ㇡ ㇢ ㇣
笔记	笔记 📒
笔记本	笔记本 💻 📔 📓 💻 📓 📔
笔记本电脑	笔记本电脑 💻
笔记簿	笔记簿 📓 📔
笔录	笔录 📝
筆電	筆電 💻
筆記	筆記 📒
筆記本	筆記本 💻 📓 📔
筆記本電腦	筆記本電腦 💻
筆記簿	筆記簿 📓 📔
筆錄	筆錄 📝
鄙视	鄙视 👎 👎🏻 👎🏼 👎🏽 👎🏾 👎🏿 🖕 😒 🖕🏻 🖕🏻 😒
鄙視	鄙視 👎 🖕 😒 🖕🏻 🖕🏻 😒
毕业	毕业 🎓
闭目养神	闭目养神 😑
闭眼	闭眼 😝
闭嘴	闭嘴 🤐 🤭 🙊 🤫 😠 😷 🤐 🫢
畢業	畢業 🎓
畢業帽	畢業帽 🎓
閉目養神	閉目養神 😑
閉眼	閉眼 😝
閉嘴	閉嘴 😠 🙊 🤐 🤭 🤐 🫢
壁虎	壁虎 🦎
壁炉钟	壁炉钟 🕰 🕰️
壁爐鐘	壁爐鐘 🕰 🕰️
边防	边防 🛂
边检	边检 🛂
蝙蝠	蝙蝠 🦇
鞭炮	鞭炮 🧨
邊防	邊防 🛂
邊檢	邊檢 🛂
便便	便便 💩
便餐	便餐 🥡
便当	便当 🍱 🥡 🥡
便當	便當 🍱 🥡 🥡
便利店	便利店 🏪
便利商店	便利商店 🏪
便条	便条 📝
便條	便條 📝
标靶	标靶 🎯
标签	标签 🏷 📑 🏷️ 📑
标志	标志 ㍻ ㍼ ㍽ ㍾ ㍿ ✆ ☏ 〒 〶 〠 ☢ ☣ ☠ ♲ ♳ ♴ ♵ ♶ ♷ ♸ ♹ ♺ ♻ ♼ ♽ ♾ ℠ $ € ¥ ¢ £ ₽ ₨ ₩ ฿ ₺ ₮ ₱ ₭ ₴ ₦ ৲ ৳ ૱ ௹ ﷼ ₹ ₲ ₪ ₡ ₫ ៛ ₵ ₢ ₤ ₳ ₠ ₣ ₰ ₧ ₯ ♩ ♪ ♫ ♬ ♭ ♮ ♯ ♠ ♣ ♥ ♦ ♿ ⚠ ⚡ ⛔ ✅ 🅰 🅱 🅾 🅿 🆎 💭 📵 🔞 🚫 🚬 🚭 🚮 🚯 🚰 🚱 🚳 🚷 🚸 🚹 🚺 🚻 🚼 🚽 🚾 🛂 🛃 🛄 🛅
标准	标准 ⊖
標靶	標靶 🎯
標籤	標籤 🏷 📑 🏷️ 📑
標誌	標誌 ♠ ♣ ♥ ♦ ♿ ⚠ ⚡ ⛔ ✅ ➿ 🅰 🅱 🅾 🅿 🆎 💭 📵 🔞 🚫 🚬 🚭 🚮 🚯 🚰 🚱 🚳 🚷 🚸 🚹 🚺 🚻 🚼 🚽 🚾 🛂 🛃 🛄 🛅
表	表 🕛 🕧 🕐 🕜 🕑 🕝 🕒 🕞 🕓 🕟 🕔 🕠 🕕 🕡 🕖 🕢 🕗 🕣 🕘 🕤 🕙 🕥 🕚 🕦 📈 📉 📊 ⌚ ⌚️
表情	表情 ☺ 😁 😂 😃 😄 😅 😆 😇 😈 😉 😊 😋 😌 😍 😎 😏 😐 😒 😓 😔 😕 😖 😘 😚 😜 😝 😞 😠 😡 😢 😣 😤 😥 😨 😩 😪 😫 😭 😰 😱 😲 😳 😵 😶 😷 😸 😹 😺 😻 😼 😽 😾 😿 🙀
表演艺术	表演艺术 🎭
表演藝術	表演藝術 🎭
表意不好	表意不好 🙅
表意好	表意好 🙆
錶	錶 ⌚ ⌚️
憋屈	憋屈 🙎 🙎🏻‍♀ 🙎🏻‍♂ 🙎🏻
別出聲	別出聲 🤫
別煩我	別煩我 😑
別理我	別理我 😑
別亂講	別亂講 🙊
別亂說	別亂說 🙊
別騙我	別騙我 😳
別墅	別墅 🏡
別墅區	別墅區 🏘 🏘️
別說	別說 🤭 🫢
別說了	別說了 🤐 🤭 🤐 🫢
別在意	別在意 🙏 🙏🏻 🙏🏻
別針	別針 🧷
别出声	别出声 🤫
别烦我	别烦我 😑
别理我	别理我 😑
别乱讲	别乱讲 🙊
别乱说	别乱说 🙊
别骗我	别骗我 😳
别墅	别墅 🏡 🏘 🏡
别墅区	别墅区 🏘 🏘️
别说	别说 🤭 🫢
别说了	别说了 🤐 🤭 🤐 🫢
别在意	别在意 🙏 🙏🏻 🙏🏻
别针	别针 🧷
宾馆	宾馆 🏨 🏩 🏨
賓館	賓館 🏨 🏩 🏨
冰	冰 🧊
冰刀	冰刀 ⛸ ⛸️
冰岛	冰岛 🇮🇸
冰島	冰島 🇮🇸
冰壶	冰壶 🥌
冰激淋	冰激淋 🍨
冰激凌	冰激凌 🍦 🍧 🍨
冰块	冰块 🧊
冰冷	冰冷 🥶
冰淇淋	冰淇淋 🍦 🍨 🍧 🍨
冰球	冰球 🏒
冰鞋	冰鞋 ⛸ ⛸️
饼	饼 🥞 🌮 🌯 🀙 🀚 🀛 🀜 🀝 🀞 🀟 🀠 🀡 🫓
饼干	饼干 🥨 🥯 🥠 🍩 🍪 🍘 🧇 🍪
餅乾	餅乾 🍪
并	并 ∪
并集	并集 ∪
病毒	病毒 🦠
病菌	病菌 🦠
病了	病了 🚑 🤒
病原体	病原体 🦠
病原體	病原體 🦠
病院	病院 🏥
波多黎各	波多黎各 🇵🇷
波黑	波黑 🇧🇦
波兰	波兰 🇵🇱
波蘭	波蘭 🇵🇱
波浪	波浪 🌊 〰 🌊
波浪号	波浪号 〰 〰️
波浪號	波浪號 〰 〰️
波浪线	波浪线 〰
波浪線	波浪線 〰
波利维亚	波利维亚 🇧🇴
波利維亞	波利維亞 🇧🇴
波罗	波罗 🍍
波羅	波羅 🍍
波奈	波奈 🇧🇶
波士尼亚赫塞哥维纳	波士尼亚赫塞哥维纳 🇧🇦
波士尼亞	波士尼亞 🇧🇦
波士尼亞赫塞哥維納	波士尼亞赫塞哥維納 🇧🇦
波斯	波斯 🇮🇷
波斯尼亚	波斯尼亚 🇧🇦
波斯尼亚和黑塞哥维那	波斯尼亚和黑塞哥维那 🇧🇦
波斯尼亚和黑塞哥维纳	波斯尼亚和黑塞哥维纳 🇧🇦
波斯尼亞和黑塞哥維納	波斯尼亞和黑塞哥維納 🇧🇦
波扎那	波扎那 🇧🇼
波札那	波札那 🇧🇼
玻尔	玻尔 尼尔斯·玻尔 Niels Bohr
玻利维亚	玻利维亚 🇧🇴
玻利維亞	玻利維亞 🇧🇴
菠萝	菠萝 🍍
菠蘿	菠蘿 🍍
播放	播放 ⏯ ▶ ⏯️ ▶️
播放一次	播放一次 🔂
伯利兹	伯利兹 🇧🇿
帛琉	帛琉 🇵🇼
泊车	泊车 🅿 🅿️
泊車	泊車 🅿 🅿️
博茨瓦纳	博茨瓦纳 🇧🇼
博奈尔	博奈尔 🇧🇶
博奈爾	博奈爾 🇧🇶
博士	博士 👨‍🎓 🧑‍🎓 👩‍🎓 👨🏻‍🎓 👨🏼‍🎓 👨🏽‍🎓 👨🏾‍🎓 👨🏿‍🎓 🧑🏻‍🎓 🧑🏼‍🎓 🧑🏽‍🎓 🧑🏾‍🎓 🧑🏿‍🎓 👩🏻‍🎓 👩🏼‍🎓 👩🏽‍🎓 👩🏾‍🎓 👩🏿‍🎓 🧑🏻‍🎓
博兹瓦纳	博兹瓦纳 🇧🇼
捕	捕 🈨
哺乳	哺乳 🤱 🤱🏻 🤱🏼 🤱🏽 🤱🏾 🤱🏿 🤱🏻
不	不 🙅‍♂ 🙅 🙅‍♀ 🆖 🙅🏻‍♂ 🙅🏼‍♂ 🙅🏽‍♂ 🙅🏾‍♂ 🙅🏿‍♂ 🙅🏻 🙅🏼 🙅🏽 🙅🏾 🙅🏿 🙅🏻‍♀ 🙅🏼‍♀ 🙅🏽‍♀ 🙅🏾‍♀ 🙅🏿‍♀ 🙅🏻
不错	不错 😎
不错啊	不错啊 😀 😺
不錯	不錯 😎
不錯啊	不錯啊 😀 😺
不丹	不丹 🇧🇹
不得	不得 🚫
不得入内	不得入内 🚫
不等	不等 ≠
不等于	不等于 ≠
不懂	不懂 😵 😵 😵‍💫
不对吧	不对吧 🤨
不對吧	不對吧 🤨
不敢看	不敢看 🙈
不敢说	不敢说 🙊
不敢說	不敢說 🙊
不敢听	不敢听 🙉
不敢聽	不敢聽 🙉
不干	不干 😝 🙅 🙅🏻‍♀ 🙅🏻‍♂ 😝 🙅🏻
不幹	不幹 😝 🙅 🙅🏻‍♀ 🙅🏻‍♂ 😝 🙅🏻
不高兴	不高兴 😒 😠 😩 😩
不高興	不高興 😒 😠 😩 😩
不告诉你	不告诉你 😏
不告訴你	不告訴你 😏
不关我事	不关我事 💁 🤷🏻‍♀ 🤷🏻‍♂ 🤷🏻
不關我事	不關我事 💁 🤷🏻‍♀ 🤷🏻‍♂ 🤷🏻
不管	不管 💁 🤷🏻‍♀ 🤷🏻‍♂ 🤷🏻
不行	不行 🙅‍♂ 🙅 🙅‍♀ 🆖 🙅🏻‍♂ 🙅🏼‍♂ 🙅🏽‍♂ 🙅🏾‍♂ 🙅🏿‍♂ 🙅🏻 🙅🏼 🙅🏽 🙅🏾 🙅🏿 🙅🏻‍♀ 🙅🏼‍♀ 🙅🏽‍♀ 🙅🏾‍♀ 🙅🏿‍♀ ✋ 😝 😝 🙅🏻
不好	不好 🆖 👎 🙅 🙅🏻‍♀ 🙅🏻‍♂ 🆖️ 🙅🏻
不好吧	不好吧 😰
不好玩	不好玩 😝 😴
不好意思	不好意思 🙏 🙏🏻 🙏🏻
不許看	不許看 🙈
不許說	不許說 🙊
不許聽	不許聽 🙉
不怀好意	不怀好意 😼
不懷好意	不懷好意 😼
不会	不会 😝
不会吧	不会吧 😟 😦
不会啦	不会啦 😝
不會	不會 😝
不會吧	不會吧 😟 😦
不會啦	不會啦 😝
不见	不见 😣
不見	不見 😣
不讲	不讲 🤐
不講	不講 🤐
不解	不解 😕 😖 🥴 🤔 🤨 ❓ ❔
不开心	不开心 😔 😞 😠 😞
不開心	不開心 😔 😞 😠 😞
不看	不看 🙈 😣 😣
不可	不可 🙅
不可能	不可能 😛 😟
不哭	不哭 🤗
不列颠	不列颠 🇬🇧
不列顛	不列顛 🇬🇧
不能看	不能看 🙈
不能说	不能说 😷 🙊 🤭 🙊 🫢
不能說	不能說 😷 🙊 🤭 🙊 🫢
不能听	不能听 🙉
不能聽	不能聽 🙉
不清楚	不清楚 🤷‍♂ 🤷 🤷‍♀ 🤷🏻‍♂ 🤷🏼‍♂ 🤷🏽‍♂ 🤷🏾‍♂ 🤷🏿‍♂ 🤷🏻 🤷🏼 🤷🏽 🤷🏾 🤷🏿 🤷🏻‍♀ 🤷🏼‍♀ 🤷🏽‍♀ 🤷🏾‍♀ 🤷🏿‍♀ 😲 😲
不是吧	不是吧 😢 😥 😿 🤨 😢 😢 😥 😿 😿 🤨
不爽	不爽 ☹ 😕 ☹️
不说	不说 😷 🙊 🤐 🤭 🤐 🫢
不说了	不说了 😷 🤭 🫢
不說	不說 😷 🙊 🤐 🤭 🤐 🫢
不說了	不說了 😷 🤭 🫢
不听	不听 🙉
不聽	不聽 🙉
不通	不通 ⛔ 🚧 ⛔️ 🚧
不喜欢	不喜欢 🥴
不喜歡	不喜歡 🥴
不晓得	不晓得 😲
不曉得	不曉得 😲
不屑	不屑 😒 😕
不信	不信 😓 😳
不许看	不许看 🙈
不许说	不许说 🙊
不许听	不许听 🙉
不要	不要 😣
不要怕	不要怕 🤗
不一定	不一定 😕
不允許	不允許 ❎
不允许	不允许 ❎
不知道	不知道 🤷‍♂ 🤷 🤷‍♀ 🤷🏻‍♂ 🤷🏼‍♂ 🤷🏽‍♂ 🤷🏾‍♂ 🤷🏿‍♂ 🤷🏻 🤷🏼 🤷🏽 🤷🏾 🤷🏿 🤷🏻‍♀ 🤷🏼‍♀ 🤷🏽‍♀ 🤷🏾‍♀ 🤷🏿‍♀ 😲 😲 🤷🏻
不准	不准 🚫
不准看	不准看 🙈
不准说	不准说 🙊
不准說	不准說 🙊
不准听	不准听 🙉
不准聽	不准聽 🙉
不准吸烟	不准吸烟 🚭
不准吸煙	不准吸煙 🚭
布丁	布丁 🍮
布基纳法索	布基纳法索 🇧🇫
布基納法索	布基納法索 🇧🇫
布吉纳法索	布吉纳法索 🇧🇫
布吉納法索	布吉納法索 🇧🇫
布隆迪	布隆迪 🇧🇮
布维岛	布维岛 🇧🇻
部首	部首 丨 亅 丿 乛 一 乙 丶 乚 十 厂 匚 刂 卜 冂 亻 八 人 入 勹 儿 匕 几 亠 冫 丷 冖 讠 凵 卩 阝 刀 力 又 厶 廴 干 艹 屮 彳 巛 川 辶 寸 大 飞 彑 工 弓 廾 广 己 彐 巾 口 马 门 宀 女 犭 山 彡 尸 饣 士 扌 氵 纟 巳 土 囗 兀 夕 小 忄 幺 弋 尢 夂 子 贝 比 灬 长 车 歹 斗 厄 方 风 父 戈 卝 户 火 旡 见 斤 耂 毛 木 牛 牜 爿 片 攴 攵 气 欠 犬 日 氏 礻 手 殳 水 瓦 王 韦 文 无 毋 心 穴 牙 爻 曰 月 爫 支 止 爪 白 癶 甘 瓜 禾 钅 立 龙 矛 皿 母 目 疒 鸟 皮 生 石 矢 示 罒 田 玄 疋 业 衤 用 玉 臣 虫 而 耳 缶 艮 虍 臼 老 耒 米 糸 齐 肉 色 舌 糹 网 西 覀 行 血 羊 页 衣 羽 聿 至 舟 竹 自 辰 赤 辵 豆 谷 龟 角 里 卤 麦 身 豕 辛 言 邑 酉 鱼 豸 走 足 采 齿 非 阜 金 隶 黾 青 雨 隹 釒 革 骨 鬼 韭 面 食(飠) 首 香 音 髟 高 鬲 黄 鹿 麻 鼎 黑 黍 鼓 鼠 裏 鼻 龠
才怪	才怪 😒 🙄
财	财 ㊖ ㈶
财迷	财迷 🤑
財迷	財迷 🤑
裁判	裁判 🕴 🕴🏻 🕴🏻
彩带	彩带 🎀
彩蛋	彩蛋 🎉
彩虹	彩虹 🌈 🏳‍🌈 🌈
彩虹旗	彩虹旗 🏳‍🌈
彩礼	彩礼 💝
彩禮	彩禮 💝
彩旗	彩旗 🚩
彩球	彩球 🎊
彩色碎纸	彩色碎纸 🎊
彩色碎紙	彩色碎紙 🎊
彩心	彩心 💙 💚 💛 💜
綵帶	綵帶 🎀
綵蛋	綵蛋 🎉
綵旗	綵旗 🚩
綵球	綵球 🎊
踩	踩 👎 👎🏻 👎🏻
菜	菜 🥬 🍅 🍆 🥒 🥕 🌶 🥦 🥗 🍅 🍆 🥒 🥕 🌶 🥦 🥗 🥬 🫒 🫑 🫘 🥬
菜刀	菜刀 🔪
菜花	菜花 🥦
菜篮	菜篮 🧺
菜籃	菜籃 🧺
菜青虫	菜青虫 🐛
菜青蟲	菜青蟲 🐛
参禅	参禅 🧘🏻‍♀ 🧘🏻‍♂ 🧘🏻
参考	参考 ※
參禪	參禪 🧘🏻‍♀ 🧘🏻‍♂ 🧘🏻
餐具	餐具 🥄 🍴 🍽 🥣 🥢 🥄 🍴 🍽 🥣 🥢 🫖
餐铃	餐铃 🛎 🛎️
餐鈴	餐鈴 🛎 🛎️
餐盘	餐盘 🍽 🍽️
餐盤	餐盤 🍽 🍽️
餐厅	餐厅 🍴
餐廳	餐廳 🍴
餐饮	餐饮 ☕
餐飲	餐飲 ☕
残疾人设施	残疾人设施 ♿ ♿️
残阳	残阳 🌇
残月	残月 🌘 🌙 🌘
残障	残障 ♿
残障人士	残障人士 ♿
殘疾人設施	殘疾人設施 ♿ ♿️
殘陽	殘陽 🌇
殘月	殘月 🌘 🌙 🌘
殘障	殘障 ♿
殘障人士	殘障人士 ♿
惨	惨 😫 😦 😦 😫
慘	慘 😫 😦 😦 😫
仓鼠	仓鼠 🐹
仓鼠脸	仓鼠脸 🐹
苍蝇	苍蝇 𓆦 🪰
倉鼠	倉鼠 🐹
倉鼠臉	倉鼠臉 🐹
操	操 🖕 🖕🏻 🖕🏼 🖕🏽 🖕🏾 🖕🏿 🤬 🤬
操你妈	操你妈 🤬
操你媽	操你媽 🤬
槽耐	槽耐 🤮
草	草 🌿
草地曲棍球	草地曲棍球 🏑
草花	草花 ♣
草莓	草莓 🍓
草莓蛋糕	草莓蛋糕 🍰
草泥马	草泥马 🦙
草药	草药 🌿
草藥	草藥 🌿
厕所	厕所 🚾 🚹 🚺 🚽 🚽 🚾
廁所	廁所 🚽 🚾
叉	叉 🔱 ❎ ❎
叉叉	叉叉 ❌
插头	插头 🔌
插頭	插頭 🔌
插销	插销 🔌
茶	茶 🍵
茶杯	茶杯 🍵
查包	查包 🛃
查德	查德 🇹🇩
查行李	查行李 🛃 🛄
查询	查询 📖 🔍
查詢	查詢 📖 🔍
查找	查找 🔍 🔎 🔍
查证	查证 🛂
查證	查證 🛂
差	差 👎 👎🏻 👎🏻
差佬	差佬 👮 👮🏻‍♀ 👮🏻‍♂ 👮🏻‍♂️
差人	差人 👮 👮🏻‍♀ 👮🏻‍♂ 👮🏻
馋	馋 🤤 😋 😋 🤤
缠头	缠头 👳🏻‍♀ 👳🏻‍♂ 👳🏾
纏頭	纏頭 👳🏻‍♀ 👳🏻‍♂ 👳🏾
饞	饞 😋 🤤
颤抖	颤抖 😨 😱
長度	長度 ↕ ↕️
長棍麫包	長棍麫包 🥖
長棍麵包	長棍麵包 🥖
長號	長號 🎺
長貨車	長貨車 🚛
長頸鹿	長頸鹿 🦒
長褲	長褲 👖
長曲棍球	長曲棍球 🥍
長條圖	長條圖 📊
長筒靴	長筒靴 👢
長靴	長靴 👢
長者	長者 👴 👵 🧓🏻 🧓🏻
尝	尝 👅
常绿乔木	常绿乔木 🌲
常綠喬木	常綠喬木 🌲
常青树	常青树 🌲
常青樹	常青樹 🌲
嘗	嘗 👅
唱	唱 🎤 🎤️
唱歌	唱歌 🎤 🎤️
唱歌符号	唱歌符号 〽
唱歌符號	唱歌符號 〽
超人	超人 🦸‍♂ 🦸 🦸‍♀ 🦸🏻‍♂ 🦸🏼‍♂ 🦸🏽‍♂ 🦸🏾‍♂ 🦸🏿‍♂ 🦸🏻 🦸🏼 🦸🏽 🦸🏾 🦸🏿 🦸🏻‍♀ 🦸🏼‍♀ 🦸🏽‍♀ 🦸🏾‍♀ 🦸🏿‍♀ 🦸🏻
朝鲜	朝鲜 🇰🇵
朝鮮	朝鮮 🇰🇵
朝阳	朝阳 🌄
朝陽	朝陽 🌄
嘲讽	嘲讽 👎
嘲諷	嘲諷 👎
嘲弄	嘲弄 😝
嘲笑	嘲笑 😝
潮男	潮男 👨🏻‍🎤 👨🏻‍🎤️
潮女	潮女 👩🏻‍🎤 👩🏻‍🎤️
潮汐	潮汐 🌊
炒虾	炒虾 🍤
炒蝦	炒蝦 🍤
车	车 🚗 🚕 🚙 🚌 🚎 🏎 🚓 🚑 🚒 🚐 🚚 🚛 🚔 🚍 🚘 🚖 🛺 🚗 🚕 🚙 🚌 🚎 🏎 🚓 🚑 🚒 🚐 🚚 🚛 🎢 🛻 🚔 🚍 🚘 🚖 🛺 🚗
车来了	车来了 🚘
车厘子	车厘子 🍒
车头	车头 🚆
车箱	车箱 🚆
车站	车站 🚉 🚏
车子	车子 🚗 🚘
車	車 🚗 🚘 🚕 🚙 🚌 🚎 🏎 🚓 🚑 🚒 🚐 🚚 🚛 🚔 🚍 🚖 🚗 🚕 🚙 🚌 🚎 🏎 🚓 🚑 🚒 🚐 🚚 🚛 🎢 🛻 🚔 🚍 🚘 🚖 🛺 🚗
車來了	車來了 🚘
車厘子	車厘子 🍒
車頭	車頭 🚆
車箱	車箱 🚆
車站	車站 🚉 🚏
車子	車子 🚗 🚘
唓	唓 😏 😝 🤪 🤪
扯谎	扯谎 🤥
扯謊	扯謊 🤥
撤回	撤回 ↩ ↩️
撤销	撤销 ↩ ↩️
撤銷	撤銷 ↩ ↩️
沉睡	沉睡 💤
沉思	沉思 😔
衬衫	衬衫 👔 👕 👔
衬衫领带	衬衫领带 👔
衬衣	衬衣 👔
襯衫	襯衫 👔 👕 👔
襯衫領帶	襯衫領帶 👔
襯衣	襯衣 👔
称赞	称赞 👍
稱贊	稱贊 👍
稱讚	稱讚 👍
撐傘	撐傘 ☔ ☔️
撑伞	撑伞 ☔ ☔️
成年人	成年人 🧑🏻
成人	成人 🔞 🧑🏻 🧑🏻
成人节目	成人节目 🔞
成人節目	成人節目 🔞
成双成对	成双成对 👫 👫🏻
成雙成對	成雙成對 👫 👫🏻
城堡	城堡 🏯 🏰
城轨	城轨 🚈 🚇 🚊 🚞 🚋 🚃 🚟
城軌	城軌 🚈 🚇 🚊 🚞 🚋 🚃 🚟
城市	城市 🏙 🏙️
乘	乘 × * ❌ ⊗ ✖ ✖️
乘号	乘号 ✖
乘號	乘號 ✖
乘积	乘积 ∏
程序员	程序员 👨‍💻 🧑‍💻 👩‍💻 👨🏻‍💻 👨🏼‍💻 👨🏽‍💻 👨🏾‍💻 👨🏿‍💻 🧑🏻‍💻 🧑🏼‍💻 🧑🏽‍💻 🧑🏾‍💻 🧑🏿‍💻 👩🏻‍💻 👩🏼‍💻 👩🏽‍💻 👩🏾‍💻 👩🏿‍💻 🧑🏻‍💻
程序員	程序員 👨🏻‍💻 👩🏻‍💻 🧑🏻‍💻
橙心	橙心 🧡
橙子	橙子 🍊
秤	秤 ⚖ ⚖️
吃吧	吃吧 😋
吃饭	吃饭 🍚
吃角子老虎	吃角子老虎 🎰
吃惊	吃惊 😱 😲
吃驚	吃驚 😱 😲
吃面	吃面 🍜
吃药	吃药 💊
吃藥	吃藥 💊
喫吧	喫吧 😋
喫飯	喫飯 🍚
喫麵	喫麵 🍜
嗤笑	嗤笑 😏
尺	尺 📏 📐 📏
尺子	尺子 📏
齿	齿 🦷
齿轮	齿轮 ⚙ ⚙️ ⚙️
齒	齒 🦷
齒輪	齒輪 ⚙ ⚙️
赤道几内亚	赤道几内亚 🇬🇶
赤道幾內亞	赤道幾內亞 🇬🇶
赤道幾内亞	赤道幾内亞 🇬🇶
冲浪	冲浪 🏄‍♂ 🏄 🏄‍♀ 🏄🏻‍♂ 🏄🏼‍♂ 🏄🏽‍♂ 🏄🏾‍♂ 🏄🏿‍♂ 🏄🏻 🏄🏼 🏄🏽 🏄🏾 🏄🏿 🏄🏻‍♀ 🏄🏼‍♀ 🏄🏽‍♀ 🏄🏾‍♀ 🏄🏿‍♀ 🏄🏻
冲凉	冲凉 🚿
冲澡	冲澡 🚿
充电	充电 🔌 🔋
沖浪	沖浪 🏄
沖涼	沖涼 🚿
衝浪	衝浪 🏄 🏄🏻‍♀ 🏄🏻‍♂ 🏄🏻
衝澡	衝澡 🚿
虫	虫 🐛 🐛 🪱 🐞 🪲 🪳 🦗 🦟 🐜 🪰 🐌 🐝
虫子	虫子 🐜
崇拜	崇拜 🙇‍♂ 🙇‍ 🙇‍♀ 🙇🏻‍♂ 🙇🏼‍♂ 🙇🏽‍♂ 🙇🏾‍♂ 🙇🏿‍♂ 🙇🏻 🙇🏼 🙇🏽 🙇🏾 🙇🏿 🙇🏻‍♀ 🙇🏼‍♀ 🙇🏽‍♀ 🙇🏾‍♀ 🙇🏿‍♀ 🙇 🙇🏻
蟲	蟲 🐛 🐛 🪱 🐞 🪲 🪳 🦗 🦟 🐜 🪰 🐌 🐝
蟲子	蟲子 🐛 🐜
抽水马桶	抽水马桶 🚽
抽水馬桶	抽水馬桶 🚽
抽烟	抽烟 🚬
抽菸	抽菸 🚬
抽煙	抽煙 🚬
愁眉苦臉	愁眉苦臉 😒
臭鼬	臭鼬 🦨
出丑	出丑 🤡
出醜	出醜 🤡
出国	出国 🚢
出國	出國 🚢
出海	出海 🚢
出汗	出汗 😓 🥵 💦 🥵
出警	出警 🚨
出色	出色 🤩
出生	出生 🐣
出事了	出事了 🚨
出洋相	出洋相 🤡
出遊	出遊 🚙
出游	出游 🚙
出租车	出租车 🚕 🚖 🚗 🚘 🚕
出租車	出租車 🚕 🚖 🚕
初	初 🈠
初心者	初心者 🔰
初中	初中 🏫
除	除 ÷ / ➗ ⨸ ➗
除号	除号 ➗
除號	除號 ➗
厨师	厨师 👨‍🍳 🧑‍🍳 👩‍🍳 👨🏻‍🍳 👨🏼‍🍳 👨🏽‍🍳 👨🏾‍🍳 👨🏿‍🍳 🧑🏻‍🍳 🧑🏼‍🍳 🧑🏽‍🍳 🧑🏾‍🍳 🧑🏿‍🍳 👩🏻‍🍳 👩🏼‍🍳 👩🏽‍🍳 👩🏾‍🍳 👩🏿‍🍳 🧑🏻‍🍳
厨子	厨子 👨🏻‍🍳 👩🏻‍🍳 🧑🏻‍🍳
锄	锄 ⛏ ⚒
锄头	锄头 ⛏ ⚒
雏鸡	雏鸡 🐥
雏菊	雏菊 🌼
廚師	廚師 👨🏻‍🍳 👩🏻‍🍳 🧑🏻‍🍳
廚子	廚子 👨🏻‍🍳 👩🏻‍🍳 🧑🏻‍🍳
雛雞	雛雞 🐥
雛菊	雛菊 🌼
储放行李	储放行李 🛅
储蓄卡	储蓄卡 💳
儲放行李	儲放行李 🛅
儲蓄卡	儲蓄卡 💳
处女座	处女座 ♍ ♍️
畜牲	畜牲 🐄 🐃 🐂 🐐 🐏 🐖 🐑 🐕 🐩 🐈 🐄 🐃 🐂 🦬 🐐 🐏 🐖 🐑 🐕 🦮 🐕‍🦺 🐩 🐈 🐈‍⬛️
處女座	處女座 ♍ ♍️
触电	触电 ⚡ ⚡️
觸電	觸電 ⚡ ⚡️
传播	传播 📣
传呼机	传呼机 📟
传情	传情 😘
传声筒	传声筒 📣
传真	传真 📠 ℻ 📠
传真机	传真机 📠
船	船 ⛵ 🚤 🛳 ⛴ 🛥 🚢 🛶 ⚓ 𓊛 🚢 ⛴ 🛳 🛥 🚤 ⛵ 🛶 ⚓️
船長	船長 👨🏻‍✈ 👩🏻‍✈ 🧑🏻‍✈️
船帆	船帆 ⛵ ⛵️
船锚	船锚 ⚓
船錨	船錨 ⚓
船坞	船坞 ⚓ ⚓️
船塢	船塢 ⚓ ⚓️
船长	船长 👨🏻‍✈ 👩🏻‍✈ 🧑🏻‍✈️
傳播	傳播 📣
傳呼機	傳呼機 📟
傳情	傳情 😘
傳聲筒	傳聲筒 📣
傳真	傳真 📠
傳真機	傳真機 📠
串点	串点 🍢 🍡
串點	串點 🍢 🍡
串烧	串烧 🍢
串燒	串燒 🍢
床	床 🛏 🛌 🛏️
牀	牀 🛏 🛏️
创可贴	创可贴 🩹
吹	吹 🈥 🌬 🌬️
吹风	吹风 💨
吹風	吹風 💨
吹气	吹气 🌬 🌬️
吹氣	吹氣 🌬 🌬️
垂斯坦昆哈	垂斯坦昆哈 🇸🇭
锤	锤 🔨 ⚒ 🛠 🔨
锤子	锤子 🔨 ⚒ 🛠 🔨
錘子	錘子 🔨
鎚	鎚 🔨
鎚子	鎚子 🔨
春	春 🀦
春心	春心 💗
纯洁	纯洁 😇
唇	唇 👄
唇彩	唇彩 💄
唇膏	唇膏 💄
唇印	唇印 💋
純潔	純潔 😇
蠢	蠢 🤪 🐷 🐷
蠢材	蠢材 🐷
啜泣	啜泣 😢
呲牙	呲牙 😁
词典	词典 📖
茈花	茈花 🎇
辞典	辞典 📖
磁带	磁带 📼
磁帶	磁帶 📼
磁碟	磁碟 💾
磁盘	磁盘 💾
磁盤	磁盤 💾
磁铁	磁铁 🧲
磁鐵	磁鐵 🧲
磁悬浮	磁悬浮 🚄
磁悬浮列车	磁悬浮列车 🚝
磁懸浮	磁懸浮 🚄
磁懸浮列車	磁懸浮列車 🚝
次方	次方 ^
次幂	次幂 ^
刺猥	刺猥 🦔
刺猬	刺猬 🦔
聪明	聪明 😇
聰明	聰明 😇
粗粮	粗粮 🌽 🥔 🍠 🥜 🌰
粗糧	粗糧 🌽 🥔 🍠 🥜 🌰
粗气	粗气 😤
粗氣	粗氣 😤
蹙眉	蹙眉 🙍 🙍🏻‍♀ 🙍🏻‍♂ 🙍🏻
存包	存包 🛅
存入手机	存入手机 📲
存入手機	存入手機 📲
存在	存在 ∃ ∄
锉冰	锉冰 🍧
错	错 ❌ ✖ ✗ ✘ × ☒ ❎ 🙅
錯	錯 ❌ ✖ ✗ ✘ × ☒ ❎ 🙅
错误	错误 ❌ ✖ ✗ ✘ × ☒ ❎ 🙅
錯誤	錯誤 ❌ ✖ ✗ ✘ × ☒ ❎ 🙅
否	否 ❌ ✖ ✗ ✘ × ☒ ❎ 🙅
否定	否定 ❌ ✖ ✗ ✘ × ☒ ❎ 🙅
否决	否决 ❌ ✖ ✗ ✘ × ☒ ❎ 🙅
否決	否決 ❌ ✖ ✗ ✘ × ☒ ❎ 🙅
銼冰	銼冰 🍧
搭的	搭的 🚖
达芬奇	达芬奇 达·芬奇 列奥纳多·达·芬奇
达朗贝尔	达朗贝尔 ☐²
达朗贝尔算符	达朗贝尔算符 ☐²
打	打 🈱 🉅
打靶	打靶 🎯
打板球	打板球 🏏
打草地曲棍球	打草地曲棍球 🏑
打叉	打叉 ✖ ❎ ❎
打叉符号	打叉符号 ✴ ❎
打叉符號	打叉符號 ✴ ❎
打车	打车 🚖
打車	打車 🚖
打的	打的 🚖
打电话	打电话 🤙 🤙🏻 🤙🏼 🤙🏽 🤙🏾 🤙🏿 ☎ 📲
打電話	打電話 ☎ 📲
打高尔夫	打高尔夫 ⛳
打高爾夫	打高爾夫 ⛳
打给我	打给我 🤙🏻
打給我	打給我 🤙🏻
打勾	打勾 ☑ ✅ ✔ ✅
打鼔	打鼔 🥁
打哈欠	打哈欠 🥱
打击	打击 👊
打机	打机 🎮
打機	打機 🎮
打擊	打擊 👊
打结	打结 ➰
打結	打結 ➰
打开档案夹	打开档案夹 📂
打开的书本	打开的书本 📖
打开文件夹	打开文件夹 📂
打開檔案夾	打開檔案夾 📂
打開的書本	打開的書本 📖
打開文件夾	打開文件夾 📂
打瞌睡	打瞌睡 😪
打篮球	打篮球 ⛹ ⛹🏻‍♀ ⛹🏻‍♂ ⛹🏻
打籃球	打籃球 ⛹ ⛹🏻‍♀ ⛹🏻‍♂ ⛹🏻
打雷	打雷 🌩 🌩️
打麻将	打麻将 🀄 🀄️
打麻將	打麻將 🀄 🀄️
打麻雀	打麻雀 🀄 🀄️
打你	打你 👊 👊🏻 👊🏻
打牌	打牌 🃏 🃏️
打喷嚏	打喷嚏 🤧
打噴嚏	打噴嚏 🤧
打扑克	打扑克 🃏 🃏️
打撲克	打撲克 🃏 🃏️
打球	打球 ⛹ ⛹🏻‍♀ ⛹🏻‍♂ ⛹🏻
打曲棍球	打曲棍球 🏒
打圈	打圈 ➰
打伞	打伞 ☔ ☔️
打傘	打傘 ☔ ☔️
打水战	打水战 🔫
打水戰	打水戰 🔫
打死你	打死你 👊 👊🏻 👊🏻
打响指	打响指 🤞🏻
打響指	打響指 🤞🏻
打旋	打旋 ➰
打印	打印 🖨 ⎙
打印机	打印机 🖨 ⎙ 🖨️
打印機	打印機 🖨 🖨️
打遊戲	打遊戲 🎮
打游戏	打游戏 🎮
打招呼	打招呼 🙋 🙋🏻‍♀ 🙋🏻‍♂ 🙋🏻
打折	打折 🈹
打针	打针 💉
打針	打針 💉
打坐	打坐 🧘🏻‍♀ 🧘🏻‍♂ 🧘🏻
大巴	大巴 🚍
大巴车	大巴车 🚍
大巴車	大巴車 🚍
大白菜	大白菜 🥬
大白方	大白方 ⬜
大便	大便 💩
大不列颠	大不列颠 🇬🇧
大不列顛	大不列顛 🇬🇧
大厨	大厨 👨🏻‍🍳 👩🏻‍🍳 🧑🏻‍🍳
大廚	大廚 👨🏻‍🍳 👩🏻‍🍳 🧑🏻‍🍳
大肚子	大肚子 🤰🏻 🫄🏻
大恩	大恩 🙏 🙏🏻 🙏🏻
大恩大德	大恩大德 🙏 🙏🏻 🙏🏻
大法官	大法官 👨🏻‍⚖ 👩🏻‍⚖ 🧑🏻‍⚖️
大反派	大反派 🦹‍♂ 🦹 🦹‍♀ 🦹🏻‍♂ 🦹🏼‍♂ 🦹🏽‍♂ 🦹🏾‍♂ 🦹🏿‍♂ 🦹🏻 🦹🏼 🦹🏽 🦹🏾 🦹🏿 🦹🏻‍♀ 🦹🏼‍♀ 🦹🏽‍♀ 🦹🏾‍♀ 🦹🏿‍♀
大方块	大方块 ⬛ ⬜
大方塊	大方塊 ⬛ ⬜
大幅降低	大幅降低 ⏬
大幅增高	大幅增高 ⏫
大韩民国	大韩民国 🇰🇷
大韓民國	大韓民國 🇰🇷
大喊	大喊 🗣 🗣️
大黑方	大黑方 ⬛
大灰狼	大灰狼 🐺
大哭	大哭 😭
大喇叭	大喇叭 📣
大浪	大浪 🌊
大老鼠	大老鼠 🐀
大楼	大楼 🏙 🏢 🏙️ 🏢
大樓	大樓 🏙 🏢 🏙️ 🏢
大陆	大陆 🇨🇳
大陸	大陸 🇨🇳
大麻烦	大麻烦 🤦🏻‍♀ 🤦🏻‍♂ 🤦🏻
大麻煩	大麻煩 🤦🏻‍♀ 🤦🏻‍♂ 🤦🏻
大马	大马 🇲🇾
大馬	大馬 🇲🇾
大米	大米 🌾
大漠	大漠 🏜 🏜️
大拇指	大拇指 👍 👍🏻 👍🏻 👍🏻
大脑	大脑 🧠
大腦	大腦 🧠
大桥	大桥 🌉
大橋	大橋 🌉
大人	大人 👨 👩 🧑🏻 🧑🏻
大厦	大厦 🏢
大廈	大廈 🏢
大声	大声 🔊
大声公	大声公 📣
大聲	大聲 🔊
大聲公	大聲公 📣
大蒜	大蒜 🧄
大头钉	大头钉 📌 📍 📌
大頭釘	大頭釘 📌 📍 📌
大腿	大腿 🦵🏻
大虾	大虾 🦐
大蝦	大蝦 🦐
大象	大象 🐘 𓃰 🐘
大笑	大笑 😀 😁 😂 🤣 😃 😄 😅 😆 😉 😊 😋 😎 😺 😸 😹 🤣
大写	大写 🔠
大写字母	大写字母 🔠
大寫字母	大寫字母 🔠
大猩猩	大猩猩 🦍
大熊猫	大熊猫 🐼
大熊貓	大熊貓 🐼
大学生	大学生 👨🏻‍🎓 👩🏻‍🎓 🧑🏻‍🎓
大學生	大學生 👨🏻‍🎓 👩🏻‍🎓 🧑🏻‍🎓
大雪	大雪 ☃ ☃️
大洋洲	大洋洲 🌏
大衣	大衣 🧥
大英	大英 🇬🇧
大于	大于 > ≥ ≫
大于等于	大于等于 ≥
大雨	大雨 🌧 🌧️
大闸蟹	大闸蟹 🦀
大閘蟹	大閘蟹 🦀
大正	大正 ㍽
大状	大状 👨🏻‍⚖ 👩🏻‍⚖ 🧑🏻‍⚖️
大狀	大狀 👨🏻‍⚖ 👩🏻‍⚖ 🧑🏻‍⚖️
大自然	大自然 🔥 💧 🌬 ☀ 🌤 ⛅ 🌦 🌥 ☁ 🌨 🌧 🌩 ⛈ ❄ 💨 🌪 🌫 🌊 🔥 💧 🌬 🫧 ☀️ 🌤 ⛅ 🌦 🌥 ☁️ 🌨 🌧 🌩 ⛈ ❄️ 💨 🌪 🌫 🌊 🧊 🪨
呆然	呆然 😐
呆子	呆子 🤓
代	代 ㈹
带锁行李	带锁行李 🛅
帶鎖行李	帶鎖行李 🛅
袋棍球	袋棍球 🥍
袋鼠	袋鼠 🦘
袋鼠国	袋鼠国 🇦🇺
袋鼠國	袋鼠國 🇦🇺
戴口罩	戴口罩 😷
丹麦	丹麦 🇩🇰
丹麥	丹麥 🇩🇰
担心	担心 😟 😰 😓
担忧	担忧 😔
单板	单板 🏂 🏂🏻
单板滑雪	单板滑雪 🏂 🏂🏻
单车	单车 🚲
单峰骆驼	单峰骆驼 🐪
单峰驼	单峰驼 🐪
单轨电车	单轨电车 🚝
单轨列车	单轨列车 🚝
单亲爸爸	单亲爸爸 👨‍👦 👨‍👧 👨‍👧‍👦
单亲家庭	单亲家庭 👨‍👦 👨‍👧 👨‍👧‍👦 👩‍👦 👩‍👧 👩‍👧‍👦
单亲妈妈	单亲妈妈 👩‍👦 👩‍👧 👩‍👧‍👦
单曲播放	单曲播放 🔁
单曲循环	单曲循环 🔂
单人	单人 👤
单身父亲	单身父亲 👨‍👦 👨‍👧 👨‍👧‍👦
单身母亲	单身母亲 👩‍👦 👩‍👧 👩‍👧‍👦
单位	单位 Å ℃ ％ ‰ ‱ ° ℉ ㏃ ㏆ ㎈ ㏄ ㏅ ㎝ ㎠ ㎤ ㏈ ㎗ ㎙ ㎓ ㎬ ㏉ ㏊ ㏋ ㎐ ㏌ ㎄ ㎅ ㎉ ㎏ ㎑ ㏍ ㎘ ㎞ ㎢ ㎦ ㎪ ㏏ ㎸ ㎾ ㏀ ㏐ ㏓ ㎧ ㎨ ㎡ ㎥ ㎃ ㏔ ㎎ ㎒ ㏕ ㎖ ㎜ ㎟ ㎣ ㏖ ㎫ ㎳ ㎷ ㎽ ㏁ ㎁ ㎋ ㎚ ㎱ ㎵ ㎻ ㏘ ㎩ ㎊ ㏗ ㏙ ㏚ ㎰ ㎴ ㎺ ㎭ ㎮ ㎯ ㏛ ㏜ ㎔ ㏝ ㎂ ㎌ ㎍ ㎕ ㎛ ㎲ ㎶ ㎼
单选按钮	单选按钮 🔘
单选框	单选框 🔘
單板	單板 🏂 🏂🏻
單板滑雪	單板滑雪 🏂 🏂🏻
單車	單車 🚲
單峰駱駝	單峰駱駝 🐪
單峰駝	單峰駝 🐪
單軌電車	單軌電車 🚝
單軌列車	單軌列車 🚝
單親爸爸	單親爸爸 👨‍👦 👨‍👧 👨‍👧‍👦
單親家庭	單親家庭 👨‍👦 👨‍👧 👨‍👧‍👦 👩‍👦 👩‍👧 👩‍👧‍👦
單親媽媽	單親媽媽 👩‍👦 👩‍👧 👩‍👧‍👦
單曲播放	單曲播放 🔁
單曲循環	單曲循環 🔂
單人	單人 👤
單身父親	單身父親 👨‍👦 👨‍👧 👨‍👧‍👦
單身母親	單身母親 👩‍👦 👩‍👧 👩‍👧‍👦
單選按鈕	單選按鈕 🔘
單選框	單選框 🔘
掸指	掸指 🤞🏻
撣指	撣指 🤞🏻
擔心	擔心 😓
擔憂	擔憂 😔
诞生	诞生 🐣
淡漠	淡漠 😐 🙎
弹出	弹出 ⏏ ⏏️
弹钢琴	弹钢琴 🎹
弹琴	弹琴 🎹
蛋	蛋 🥚 🐣 🥚
蛋糕	蛋糕 🎂 🍰 🧁 🍰
蛋奶冻	蛋奶冻 🍮
蛋奶凍	蛋奶凍 🍮
蛋治	蛋治 🥪
誕生	誕生 🐣
彈出	彈出 ⏏ ⏏️
彈鋼琴	彈鋼琴 🎹
彈琴	彈琴 🎹
当然	当然 🙄
当心儿童	当心儿童 🚸
當然	當然 🙄
當心兒童	當心兒童 🚸
档案	档案 📃 📄 🗃 🗃️
档案袋	档案袋 🗂 🗂️
档案柜	档案柜 🗄 🗄️
档案盒	档案盒 🗃 🗃️
档案夹	档案夹 📁
档案箱	档案箱 🗃 🗃️
党	党 ☭
檔案	檔案 📃 📄 🗃 🗃️
檔案袋	檔案袋 🗂 🗂️
檔案櫃	檔案櫃 🗄 🗄️
檔案盒	檔案盒 🗃 🗃️
檔案夾	檔案夾 📁
檔案箱	檔案箱 🗃 🗃️
刀	刀 🔪 🗡 🍴 🍽 🔪
刀叉	刀叉 🍽 🍴 🍴
导弹	导弹 🚀
导盲犬	导盲犬 🦮 🐕‍🦺 🦮
导入手机	导入手机 📲
岛	岛 🏝 🏝️
岛国	岛国 🗾
岛屿	岛屿 🏝 🗾 🗾
倒	倒 🤒
倒彩	倒彩 🖕 🖕🏻 🖕🏻
倒带	倒带 ⏪
倒帶	倒帶 ⏪
倒挂列车	倒挂列车 🚟
倒掛列車	倒掛列車 🚟
倒楣	倒楣 😫
倒霉	倒霉 😓
倒退	倒退 ⏪ ◀ ⏪ ◀️
倒序	倒序 ‮
島	島 🏝 🏝️
島國	島國 🗾
島嶼	島嶼 🗾
導彈	導彈 🚀
導入手機	導入手機 📲
盗	盗 🉆
道观	道观 🛐
道觀	道觀 🛐
道教	道教 ☯ ☯️
道路施工	道路施工 🚧
道歉	道歉 🙇
稻	稻 🌾
稻穗	稻穗 🌾
稻田	稻田 🌾
稻子	稻子 🌾
得	得 🉐 👌 👌🏻 🉐️ 👌🏻
得意	得意 😎 😤 😏 😏
德国	德国 🇩🇪 德意志联邦共和国 🇩🇪
德国国旗	德国国旗 🇩🇪
德國	德國 🇩🇪
德國國旗	德國國旗 🇩🇪
德意志	德意志 🇩🇪
的士	的士 🚕 🚖 🚕
灯	灯 💡
灯笼	灯笼 🏮
灯泡	灯泡 💡
灯神	灯神 🧞‍♀ 🧞‍♂ 🧞
登山列车	登山列车 🚞
登山列車	登山列車 🚞
登山靴	登山靴 🥾
登山自行车手	登山自行车手 🚵
登山自行車手	登山自行車手 🚵
燈	燈 💡
燈籠	燈籠 🏮
燈泡	燈泡 💡
燈神	燈神 🧞‍♀ 🧞‍♂ 🧞
等待	等待 ⌛
等一会	等一会 ☝ ☝🏻 ☝🏻️
等一會	等一會 ☝ ☝🏻 ☝🏻️
等于	等于 = ≈ ≅ ≠ ⁼ ₌ ≡ ⇔ ↔ ↕ 🟰
瞪眼	瞪眼 😳
低落	低落 😞 🙍
低温	低温 🥶
低溫	低溫 🥶
低音量	低音量 🔉
狄拉克	狄拉克 保罗·狄拉克 Paul Dirac
迪戈加西亚岛	迪戈加西亚岛 🇩🇬
底片	底片 🎞 🎞️
地	地 ⏚
地瓜	地瓜 🍠
地球	地球 🌍 🌎 🌏 🌐 🌍 🌎 🌏
地铁	地铁 🚇 Ⓜ 🚈 Ⓜ️ 🚇
地鐵	地鐵 Ⓜ 🚇 🚈 Ⓜ️ 🚇
地图	地图 🗺 🗾 🗺️
地圖	地圖 🗺 🗺️
地下铁	地下铁 🚇
地下鐵	地下鐵 🚇
地支	地支 子 丑 寅 卯 辰 巳 午 未 申 酉 戌 亥
第二	第二 🥈
第二卷	第二卷 📗
第二名	第二名 🥈
第三	第三 🥉
第三卷	第三卷 📘
第三名	第三名 🥉
第四卷	第四卷 📙
第一	第一 ☝ 🥇 🥇
第一卷	第一卷 📕
第一名	第一名 🥇
睇戏	睇戏 🎬
睇戲	睇戲 🎬
颠倒	颠倒 🙃
顛倒	顛倒 🙃
点	点 · :00 :15 :30 :45 🉄 ㍘ ㍙ ㍚ ㍛ ㍜ ㍝ ㍞ ㍟ ㍠ ㍡ ㍢ ㍣ ㍤ ㍥ ㍦ ㍧ ㍨ ㍩ ㍪ ㍫ ㍬ ㍭ ㍮ ㍯ ㍰
点火	点火 🔥
点燃	点燃 🔥
点心	点心 🍪
点烟	点烟 🚬
点著	点著 🔥
点子	点子 💡
點火	點火 🔥
點燃	點燃 🔥
點心	點心 🍪
點菸	點菸 🚬
點煙	點煙 🚬
點著	點著 🔥
點子	點子 💡
电	电 ⚡ ⚡️
电插头	电插头 🔌
电车	电车 🚃 🚊 🚎 🚎
电池	电池 🔋
电单车	电单车 🏍 🛵 🏍️ 🛵
电灯	电灯 💡
电灯泡	电灯泡 💡
电动车	电动车 🛵
电动火车	电动火车 🚊
电话	电话 ☎ ☏ 📞 ℡ 📱 📲 ✆ 🤙 📱
电话机	电话机 ☎ ☎️
电话听筒	电话听筒 📞
电话亭	电话亭 ➿
电话筒	电话筒 📞
电话线	电话线 ➿
电力火车	电力火车 🚊
电量	电量 🔋
电流	电流 ㎀ ㎁ ㎂ ㎃ ㎄
电摩托	电摩托 🛵
电脑	电脑 💻 🖥 🖥️
电脑包	电脑包 💼
电器	电器 💡 📺 ☎ 📟 📞 📠 📻 🕰 📡 🔦 💡 📺 ☎️ 📟 📞 📠 📻 🕰 📡 🔦
电容	电容 ㎊ ㎋ ㎌
电视	电视 📺
电视机	电视机 📺
电视塔	电视塔 🗼
电视游乐器	电视游乐器 🎮
电塔	电塔 🗼
电台	电台 🗼
电压	电压 ㎴ ㎵ ㎶ ㎷ ㎸
电影	电影 🎬 🎥 🎞 📽 🈙 🎬
电影打板	电影打板 🎬
电影院	电影院 🎦 🎥 🎥
电邮	电邮 📧
电源	电源 🔌
电子	电子 ⌚ 📱 💻 ⌨ 🖥 🖨 🖱 📷 📹 💾 💽 💿 📀 ⌚️ 📱 💻 ⌨️ 🖥 🖨 🖱 📷 📹 💾 💽 💿 📀
电子邮件	电子邮件 📧 📨 📩 📤 📥 📧
电阻	电阻 ㏀ ㏁
電	電 ⚡ ⚡️
電插頭	電插頭 🔌
電車	電車 🚃 🚊 🚎 🚎
電池	電池 🔋
電單車	電單車 🏍 🛵 🏍️ 🛵
電燈	電燈 💡
電燈泡	電燈泡 💡
電動火車	電動火車 🚊
電話	電話 ☎ 📞 📱 📱
電話機	電話機 ☎ ☎️
電話聽筒	電話聽筒 📞
電話亭	電話亭 ➿
電話筒	電話筒 📞
電話線	電話線 ➿
電力火車	電力火車 🚊
電量	電量 🔋
電摩托	電摩托 🛵
電腦	電腦 💻 🖥 🖥️
電腦包	電腦包 💼
電器	電器 💡 📺 ☎ 📟 📞 📠 📻 🕰 📡 🔦 💡 📺 ☎️ 📟 📞 📠 📻 🕰 📡 🔦
電視	電視 📺
電視機	電視機 📺
電視塔	電視塔 🗼
電視遊樂器	電視遊樂器 🎮
電塔	電塔 🗼
電台	電台 🗼
電臺	電臺 🗼
電影	電影 🎥 🎬 🎬
電影打板	電影打板 🎬
電影院	電影院 🎥 🎦 🎥
電郵	電郵 📧
電源	電源 🔌
電子	電子 ⌚ 📱 💻 ⌨ 🖥 🖨 🖱 📷 📹 💾 💽 💿 📀 ⌚️ 📱 💻 ⌨️ 🖥 🖨 🖱 📷 📹 💾 💽 💿 📀
電子郵件	電子郵件 📧
凋零	凋零 🥀
凋谢	凋谢 🥀
凋謝	凋謝 🥀
貂	貂 🦡
雕像	雕像 🗽
钓鱼	钓鱼 🎣
钓鱼场	钓鱼场 🎣
釣魚	釣魚 🎣
釣魚場	釣魚場 🎣
調暗	調暗 🔅
調低	調低 🔽
調高	調高 🔼
調羹	調羹 🥄
調亮	調亮 🔆
調皮	調皮 🤪
調色	調色 🎨
調色板	調色板 🎨
調色盤	調色盤 🎨
跌	跌 📉
跌势	跌势 📉
跌勢	跌勢 📉
碟片	碟片 💽
蝶	蝶 🦋
丁丁	丁丁 🚎
盯	盯 👁 👁️
顶	顶 🆙 👍 👍🏻 👍🏻
顶呱呱	顶呱呱 👍
頂	頂 🆙 👍 👍🏻 👍🏻
頂呱呱	頂呱呱 👍
钉	钉 📌 📍 📎
定食	定食 🍱
丢脸	丢脸 🤦‍♂ 🤦 🤦‍♀ 🤦🏻‍♂ 🤦🏼‍♂ 🤦🏽‍♂ 🤦🏾‍♂ 🤦🏿‍♂ 🤦🏻 🤦🏼 🤦🏽 🤦🏾 🤦🏻‍♀ 🤦🏼‍♀ 🤦🏽‍♀ 🤦🏾‍♀ 🤦🏿‍♀
东	东 🀀
东帝汶	东帝汶 🇹🇱
东加	东加 🇹🇴
东京	东京 🗻
东京铁塔	东京铁塔 🗼
东正教	东正教 ☦ ☦️
冬	冬 🀩
東帝汶	東帝汶 🇹🇱
東加	東加 🇹🇴
東京	東京 🗻
東正教	東正教 ☦ ☦️
动车	动车 🚅
动物	动物 🐀 🐁 🐂 🐃 🐄 🐅 🐆 🐇 🐈 🐉 🐊 🐋 🐌 🐍 🐎 🐏 🐐 🐑 🐒 🐓 🐔 🐕 🐖 🐗 🐘 🐙 🐚 🐛 🐜 🐝 🐞 🐟 🐠 🐡 🐢 🐣 🐤 🐥 🐦 🐧 🐨 🐩 🐪 🐫 🐬 🐭 🐮 🐯 🐰 🐱 🐲 🐳 🐴 🐵 🐶 🐷 🐸 🐹 🐺 🐻 🐼 🐽 🐾 🦆 🦅 🦉 🦇 🦄 🦋 🕷 🦎 🦂 🦀 🦑 🦐 🦈 🦌 🦏 🦍 🦃 🕊 🐿 🦖 🦕 🦡 🦝 🦢 🦜 🦚 🦙 🦛 🦞 🦟 🦆 🦅 🦉 🦇 🐺 🐗 🦄 🐴 🐝 🐛 🐞 🪲 🦟 🐚 🐌 🦋 🐜 🕷 🐢 🐍 🦎 🦂 🦀 🦑 🐙 🦐 🦞 🦪 🐠 🐟 🐡 🐬 🦈 🐋 🐊 🐆 🐅 🐃 🐂 🐄 🦬 🦌 🐪 🐫 🐘 🦏 🦍 🦧 🦣 🐎 🐖 🐐 🐏 🐑 🐕 🐩 🐈 🐈‍⬛️ 🐓 🦃 🕊 🦩 🐇 🐁 🐀 🐿 🐉 🐒 🦖 🦕 🦡 🦝 🦨 🦫 🦦 🦭 🦥 🦢 🦜 🦤 🦚 🦙 🦛
动物表情	动物表情 🐮 🐸
动物脸	动物脸 🐶 🐱 🐭 🐹 🐰 🦊 🐻 🐼 🐨 🐯 🦁 🐮 🐷 🐽 🐸 🐵 🐶 🐱 🐭 🐹 🐰 🦊 🐻 🐻‍❄️ 🐼 🐨 🐯 🦁 🐮 🐷 🐽 🐸 🐵
动物足印	动物足印 🐾
冻	冻 🥶
洞	洞 🕳 🕳️
凍	凍 🥶
動車	動車 🚅
動物	動物 🐀 🐁 🐂 🐃 🐄 🐅 🐆 🐇 🐈 🐉 🐊 🐋 🐌 🐍 🐎 🐏 🐐 🐑 🐒 🐓 🐔 🐕 🐖 🐗 🐘 🐙 🐚 🐛 🐜 🐝 🐞 🐟 🐠 🐡 🐢 🐣 🐤 🐥 🐦 🐧 🐨 🐩 🐪 🐫 🐬 🐭 🐮 🐯 🐰 🐱 🐲 🐳 🐴 🐵 🐶 🐷 🐸 🐹 🐺 🐻 🐼 🐽 🐾 🦆 🦅 🦉 🦇 🦄 🦋 🕷 🦎 🦂 🦀 🦑 🦐 🦈 🦌 🦏 🦍 🦃 🕊 🐿 🦖 🦕 🦡 🦝 🦢 🦜 🦚 🦙 🦛 🦞 🦟 🦆 🦅 🦉 🦇 🐺 🐗 🦄 🐴 🐝 🐛 🐞 🪲 🦟 🐚 🐌 🦋 🐜 🕷 🐢 🐍 🦎 🦂 🦀 🦑 🐙 🦐 🦞 🦪 🐠 🐟 🐡 🐬 🦈 🐋 🐊 🐆 🐅 🐃 🐂 🐄 🦬 🦌 🐪 🐫 🐘 🦏 🦍 🦧 🦣 🐎 🐖 🐐 🐏 🐑 🐕 🐩 🐈 🐈‍⬛️ 🐓 🦃 🕊 🦩 🐇 🐁 🐀 🐿 🐉 🐒 🦖 🦕 🦡 🦝 🦨 🦫 🦦 🦭 🦥 🦢 🦜 🦤 🦚 🦙 🦛
動物表情	動物表情 🐮 🐸
動物臉	動物臉 🐶 🐱 🐭 🐹 🐰 🦊 🐻 🐼 🐨 🐯 🦁 🐮 🐷 🐽 🐸 🐵 🐶 🐱 🐭 🐹 🐰 🦊 🐻 🐻‍❄️ 🐼 🐨 🐯 🦁 🐮 🐷 🐽 🐸 🐵
動物足印	動物足印 🐾
都行	都行 😶
都市	都市 🏙 🏙️
抖	抖 😨 😱
逗号	逗号 ， ,
逗你玩	逗你玩 😜
嘟嘴	嘟嘴 😗 😚 🙎 😗
独角兽	独角兽 🦄
独木舟	独木舟 🛶
读书	读书 📖 🤓
读书人	读书人 🤓
獨角獸	獨角獸 🦄
獨木舟	獨木舟 🛶
讀書	讀書 📖 🤓
讀書人	讀書人 🤓
赌博	赌博 🎰 🎲 🎰
赌博机	赌博机 🎰
赌场	赌场 🎰
赌马	赌马 🏇 🏇🏻 🏇🏻
赌钱	赌钱 🎰
賭博	賭博 🎰 🎲 🎰
賭博機	賭博機 🎰
賭場	賭場 🎰
賭馬	賭馬 🏇 🏇🏻 🏇🏻
賭錢	賭錢 🎰
度	度 ° ℃ ℉
度假	度假 🏖 🏖️
渡口	渡口 ⛴ ⛴️
渡轮	渡轮 ⚓ ⛴ ⛴️
渡輪	渡輪 ⚓ ⛴ ⛴️
短裤	短裤 🩳 🩲 🩳
短袖	短袖 👕 👚
段	段 ¶ ⁋
段落	段落 ¶ ⁋
缎带	缎带 🎀
緞帶	緞帶 🎀
堆雪人	堆雪人 ⛄ ⛄️
对	对 ✅ ☑ ✓ ✔ ⭕ √ 🙆
对号	对号 ✅ ☑ ✓ ✔ ⭕ √ 🙆
yes	yes ✅ ☑ ✓ ✔ ⭕ √ 🙆
对白	对白 🗯 🗯️
对比	对比 🆚 🆚️
对不对	对不对 😈
对不起	对不起 🙏 🙏🏻 🙏🏻
对称	对称 ⌯
对话框	对话框 🗯 🗯️
对决	对决 🆚 🆚️
对抗	对抗 🆚
对上	对上 🆚 🆚️
对数	对数 ㏑ ㏒
兌換	兌換 💱
兑	兑 ☱
兑换	兑换 💱
對白	對白 🗯 🗯️
對比	對比 🆚 🆚️
對不對	對不對 😈
對不起	對不起 🙏 🙏🏻 🙏🏻
對話框	對話框 🗯 🗯️
對決	對決 🆚 🆚️
對抗	對抗 🆚
對上	對上 🆚 🆚️
吨	吨 ㌧
盾	盾 🛡 🛡️
盾牌	盾牌 🛡 🔰 🛡️
顿号	顿号 、
多	多 🈕
多哥	多哥 🇹🇬
多媒体	多媒体 📽 🎥 📹 📷 🎙 📡
多媒體	多媒體 📽 🎥 📹 📷 🎙 📡
多米尼加	多米尼加 🇩🇲 🇩🇴 🇩🇴
多米尼加共和国	多米尼加共和国 🇩🇴
多米尼克	多米尼克 🇩🇲
多明尼加	多明尼加 🇩🇴
多明尼加共和國	多明尼加共和國 🇩🇴
多人	多人 👥
多选框	多选框 ☑ ☑️
多選框	多選框 ☑ ☑️
多云	多云 ⛅ ☁ ⛅️
多云间晴	多云间晴 🌤 🌤️
多雲	多雲 ☁ ⛅ ⛅️
多雲間晴	多雲間晴 🌤 🌤️
哆嗦	哆嗦 🥶
夺冠	夺冠 🏆
奪冠	奪冠 🏆
舵	舵 ☸
俄	俄 а б в г д е ё ж з и й к л м н о п р с т у ф х ц ч ш щ ъ ы ь э ю я
俄国	俄国 🇷🇺
俄国国旗	俄国国旗 🇷🇺
俄國	俄國 🇷🇺
俄國國旗	俄國國旗 🇷🇺
俄罗斯	俄罗斯 🇷🇺
俄羅斯	俄羅斯 🇷🇺
俄语	俄语 а б в г д е ё ж з и й к л м н о п р с т у ф х ц ч ш щ ъ ы ь э ю я
峨眉月	峨眉月 🌙
娥眉月	娥眉月 🌒
鹅	鹅 🦢
额	额 😢 😥 😿
鵝	鵝 🦢
額	額 😢 😥 😿
噁心	噁心 🤢 🤮
厄瓜多	厄瓜多 🇪🇨
厄瓜多尔	厄瓜多尔 🇪🇨
厄瓜多爾	厄瓜多爾 🇪🇨
厄立特里亚	厄立特里亚 🇪🇷
厄立特里亞	厄立特里亞 🇪🇷
厄利垂亚	厄利垂亚 🇪🇷
厄利垂亞	厄利垂亞 🇪🇷
呃	呃 😢 😿 🤪
恶鬼	恶鬼 👹
恶魔	恶魔 👿 😈 😈
恶心	恶心 🤢 🤮
饿	饿 😋
饿了	饿了 😋
惡鬼	惡鬼 👹
惡魔	惡魔 👿 😈 😈
餓了	餓了 😋
鳄	鳄 🐊
鳄梨	鳄梨 🥑
鳄鱼	鳄鱼 🐊 𓆊 𓆌 𓆋 🐊
鱷	鱷 🐊
鱷魚	鱷魚 🐊
诶	诶 🤨
嗯	嗯 😶 🤨
嗯嗯	嗯嗯 😀
儿	儿 👦 👦🏻 👦🏻
儿童	儿童 👦 👧 🧒 🚸 👦🏻 👦🏼 👦🏽 👦🏾 👦🏿 👧🏻 👧🏼 👧🏽 👧🏾 👧🏿 🧒🏻 🧒🏼 🧒🏽 🧒🏾 🧒🏿 🧒🏻
儿子	儿子 👦 👨‍👩‍👦 👦🏻 👦🏻 👨‍👩‍👦
兒	兒 👦 👦🏻 👦🏻
兒童	兒童 🧒🏻
兒子	兒子 👦 👨‍👩‍👦 👦🏻 👦🏻 👨‍👩‍👦
耳	耳 👂 🦻 👂🏻 👂🏼 👂🏽 👂🏾 👂🏿 🦻🏻 🦻🏼 🦻🏽 🦻🏾 🦻🏿 👂🏻
耳朵	耳朵 👂 🦻 👂🏻 👂🏼 👂🏽 👂🏾 👂🏿 🦻🏻 🦻🏼 🦻🏽 🦻🏾 🦻🏿 👂🏻
耳放	耳放 🎧
耳机	耳机 🎧
耳機	耳機 🎧
耳仔	耳仔 👂 👂🏻 👂🏻
二	二 二、 贰 Ⅱ 〢 ² ₂ 🈔 ⓶ 𝟚 ⒉ 🄃 ㊁ ㈡ 🉂 2⃣ 𓃊 2️⃣
二十	二十 廿 〹
二头肌	二头肌 💪
二頭肌	二頭肌 💪
发	发 🀅
发抖	发抖 😨 😱
发火	发火 😡
发件匣	发件匣 📤
发件箱	发件箱 📤
发件箱托盘	发件箱托盘 📤
发狂	发狂 🤯
发廊	发廊 💈
发票	发票 🧾
发色	发色 🦲 🦰 🦱 🦳
发烧	发烧 🤒
发誓	发誓 ✊ ✊🏻 ✊🏻
发送邮件	发送邮件 📩
发型	发型 🦲 🦰 🦱 🦳
发言	发言 💬
发言气球	发言气球 💬
发言中	发言中 💬
发邮件	发邮件 📩
發火	發火 😡
發件匣	發件匣 📤
發件箱	發件箱 📤
發件箱托盤	發件箱托盤 📤
發狂	發狂 🤯
發票	發票 🧾
發燒	發燒 🤒
發誓	發誓 ✊ ✊🏻 ✊🏻
發送郵件	發送郵件 📩
發言	發言 💬
發言氣球	發言氣球 💬
發言中	發言中 💬
發郵件	發郵件 📩
廢話	廢話 🙄
廢了	廢了 😖
廢紙籮	廢紙籮 🚮
法官	法官 👨‍⚖ 🧑‍⚖ 👩‍⚖ 👨🏻‍⚖ 👨🏼‍⚖ 👨🏽‍⚖ 👨🏾‍⚖ 👨🏿‍⚖ 🧑🏻‍⚖ 🧑🏼‍⚖ 🧑🏽‍⚖ 🧑🏾‍⚖ 🧑🏿‍⚖ 👩🏻‍⚖ 👩🏼‍⚖ 👩🏽‍⚖ 👩🏾‍⚖ 👩🏿‍⚖ 🧑🏻‍⚖️
法棍	法棍 🥖
法国	法国 🇫🇷 法兰西共和国 🇫🇷
法国国旗	法国国旗 🇫🇷
法国王室	法国王室 ⚜ ⚜️
法國	法國 🇫🇷
法國國旗	法國國旗 🇫🇷
法國王室	法國王室 ⚜ ⚜️
法拉	法拉 ㎊ ㎋ ㎌
法拉利	法拉利 🏎 🏎️
法兰西	法兰西 ⚜ 🇫🇷 ⚜️ 🇫🇷
法蘭西	法蘭西 ⚜ 🇫🇷 ⚜️ 🇫🇷
法郎	法郎 ₣
法轮	法轮 ☸ ☸️
法轮大法	法轮大法 ☸ ☸️
法轮功	法轮功 ☸ ☸️
法輪	法輪 ☸ ☸️
法輪大法	法輪大法 ☸ ☸️
法輪功	法輪功 ☸ ☸️
法罗群岛	法罗群岛 🇫🇴
法羅群島	法羅群島 🇫🇴
法师	法师 🧙‍♂ 🧙 🧙‍♀ 🧙🏻‍♂ 🧙🏼‍♂ 🧙🏽‍♂ 🧙🏾‍♂ 🧙🏿‍♂ 🧙🏻 🧙🏼 🧙🏽 🧙🏾 🧙🏿 🧙🏻‍♀ 🧙🏼‍♀ 🧙🏽‍♀ 🧙🏾‍♀ 🧙🏿‍♀ 🧙🏻
法師	法師 🧙🏻‍♀ 🧙🏻‍♂ 🧙🏻
法属玻里尼西亚	法属玻里尼西亚 🇵🇫
法属圭亚那	法属圭亚那 🇬🇫
法属南部领地	法属南部领地 🇹🇫
法属南方属地	法属南方属地 🇹🇫
法屬玻里尼西亞	法屬玻里尼西亞 🇵🇫
法屬圭亞那	法屬圭亞那 🇬🇫
法屬南部領地	法屬南部領地 🇹🇫
法屬南方屬地	法屬南方屬地 🇹🇫
法杖	法杖 ☤ ‍⚕
髮廊	髮廊 💈
髮色	髮色 🦲 🦰 🦱 🦳
髮型	髮型 🦲 🦰 🦱 🦳
帆	帆 ⛵ ⛵️
帆船	帆船 ⛵ ⛵️
番茄	番茄 🍅
番茄酱	番茄酱 🥫
番茄醬	番茄醬 🥫
番薯	番薯 🍠 🥔 🥔
蕃茄	蕃茄 🍅
蕃茄酱	蕃茄酱 🥫
蕃茄醬	蕃茄醬 🥫
蕃薯	蕃薯 🍠
翻跟头	翻跟头 🤸 🤸‍♂ 🤸‍♀ 🤸🏻‍♂ 🤸🏼‍♂ 🤸🏽‍♂ 🤸🏾‍♂ 🤸🏿‍♂ 🤸🏻‍♀ 🤸🏼‍♀ 🤸🏽‍♀ 🤸🏾‍♀ 🤸🏿‍♀
翻书	翻书 📖
翻書	翻書 📖
烦	烦 😒 🤯
繁星	繁星 ✨
反	反 ¬
反对	反对 🙅
反對	反對 🙅
反派	反派 🦹‍♂ 🦹 🦹‍♀ 🦹🏻‍♂ 🦹🏼‍♂ 🦹🏽‍♂ 🦹🏾‍♂ 🦹🏿‍♂ 🦹🏻 🦹🏼 🦹🏽 🦹🏾 🦹🏿 🦹🏻‍♀ 🦹🏼‍♀ 🦹🏽‍♀ 🦹🏾‍♀ 🦹🏿‍♀
返回	返回 🔙
犯困	犯困 😪
饭	饭 🍛 🍲 🍝 🍜 🥘 🍣 🍱 🍘 🍙 🍚 🥡
饭店	饭店 🏨
饭盒	饭盒 🍱
饭团	饭团 🍙
饭碗	饭碗 🥣
泛舟	泛舟 🚣
贩	贩 🈣
梵蒂冈	梵蒂冈 🇻🇦
梵蒂岡	梵蒂岡 🇻🇦
飯	飯 🍚 🍛 🍲 🍝 🍜 🥘 🍣 🍱 🍘 🍙 🥡 🍛 🍲 🍝 🍜 🥘 🍣 🍱 🍘 🍙 🍚 🥡
飯店	飯店 🏨
飯盒	飯盒 🍱
飯團	飯團 🍙
飯糰	飯糰 🍙
飯碗	飯碗 🥣
方便袋	方便袋 🛍
方程式	方程式 🏎 🏎️
方块	方块 ◻ ◼ ♦ ◻️ ◼️
方塊	方塊 ◻ ◼ ♦ ◻️ ◼️
方框	方框 ▪ ▫ ◻ ◼ ◽ ◾ ⬛ ⬜ 🔶 🔷 🔸 🔹 💠 🔲 🔳 🟥 🟧 🟨 🟩 🟦 🟪 🟫
方片	方片 ♦ ♢ ♦️
防护镜	防护镜 🥽
防護鏡	防護鏡 🥽
房屋	房屋 🏠 🏡
房子	房子 🏘 🏚 🏠 🏡 ⌂ 🏠
放大镜	放大镜 🔍 🔎
放大鏡	放大鏡 🔍 🔎
放射	放射 ☢ ☢️
放射线	放射线 ☢ ☢️
放射線	放射線 ☢ ☢️
放射性	放射性 ☢ ☢️
放松	放松 😌
放鬆	放鬆 😌
放心	放心 😌
放映	放映 🎥
放映机	放映机 📽 📽️
放映機	放映機 📽 📽️
放映室	放映室 🎦
飞镖	飞镖 🎯
飞弹	飞弹 🚀
飞碟	飞碟 🛸 🥏
飞行	飞行 ✈
飞行器	飞行器 🛩 ✈ 🚁 🚀 🛸 🛩 ✈️ 🚁 🚀 🛸
飞行员	飞行员 👨‍✈ 🧑‍✈ 👩‍✈ 👨🏻‍✈ 👨🏼‍✈ 👨🏽‍✈ 👨🏾‍✈ 👨🏿‍✈ 🧑🏻‍✈ 🧑🏼‍✈ 🧑🏽‍✈ 🧑🏾‍✈ 🧑🏿‍✈ 👩🏻‍✈ 👩🏼‍✈ 👩🏽‍✈ 👩🏾‍✈ 👩🏿‍✈
飞机	飞机 ✈ 🛩 🛫 🛬 ✈️
飞鸟	飞鸟 🐦
飞盘	飞盘 🥏
飞吻	飞吻 😘
妃	妃 👸 👸🏻 👸🏻
妃嫔	妃嫔 👸 👸🏻 👸🏻
妃嬪	妃嬪 👸 👸🏻 👸🏻
妃子	妃子 👸 👸🏻 👸🏻
非常感谢	非常感谢 🙏 🙏🏻 🙏🏻
非常感謝	非常感謝 🙏 🙏🏻 🙏🏻
非常好	非常好 👍
非礼勿视	非礼勿视 🙈
非礼勿听	非礼勿听 🙉
非礼勿言	非礼勿言 🙊
非禮勿視	非禮勿視 🙈
非禮勿聽	非禮勿聽 🙉
非禮勿言	非禮勿言 🙊
非饮用水	非饮用水 🚱
非飲用水	非飲用水 🚱
非洲	非洲 🌍
非洲雄鹰	非洲雄鹰 🇳🇬
非洲雄鷹	非洲雄鷹 🇳🇬
非洲之角	非洲之角 🇸🇴
飛鏢	飛鏢 🎯
飛彈	飛彈 🚀
飛碟	飛碟 🛸 🥏
飛行	飛行 ✈
飛行器	飛行器 🛩 ✈ 🚁 🚀 🛸 🛩 ✈️ 🚁 🚀 🛸
飛機	飛機 ✈ ✈️
飛鳥	飛鳥 🐦
飛盤	飛盤 🥏
飛吻	飛吻 😘
菲律宾	菲律宾 🇵🇭
菲律賓	菲律賓 🇵🇭
肥皂	肥皂 🧼
肥猪	肥猪 🐖
肥豬	肥豬 🐖
斐济	斐济 🇫🇯
斐濟	斐濟 🇫🇯
废话	废话 🙄
废了	废了 😖
废纸箩	废纸箩 🚮
费用	费用 🈂
分	分 ′ ㌣
分贝	分贝 ㏈
分号	分号 ； ;
分手	分手 💔
分数	分数 ½ ⅓ ⅔ ¼ ¾ ⅕ ⅖ ⅗ ⅘ ⅙ ⅚ ⅐ ⅛ ⅜ ⅝ ⅞ ⅑ ⅒ ⅟ ↉ ℀ ℁ ℅ ℆ ⅍
分析报告	分析报告 📊
分析報告	分析報告 📊
芬兰	芬兰 🇫🇮
芬蘭	芬蘭 🇫🇮
坟	坟 ⚰ ⚰️ 🪦
愤怒	愤怒 💢 😡
墳	墳 ⚰ ⚰️ 🪦
憤怒	憤怒 💢 😡
丰收	丰收 🎑
风	风 🌬 💨 💨
风暴	风暴 🌀
风车之国	风车之国 🇳🇱
风吹落叶	风吹落叶 🍃
风景	风景 🏞 🏞️
风景区	风景区 🏞 🏞️
风铃	风铃 🎐
风铃节	风铃节 🎐
风台	风台 🌀
风衣	风衣 🧥
风筝	风筝 🪁
枫	枫 🍁
枫叶	枫叶 🍁
枫叶之国	枫叶之国 🇨🇦
封闭	封闭 〆
封口	封口 🤐
封路	封路 ⛔ ⛔️
封印	封印 〆
封装	封装 📦
封裝	封裝 📦
風	風 💨
風車之國	風車之國 🇳🇱
風吹落葉	風吹落葉 🍃
風景	風景 🏞 🏞️
風景區	風景區 🏞 🏞️
風鈴	風鈴 🎐
風鈴節	風鈴節 🎐
風颱	風颱 🌀
風衣	風衣 🧥
楓	楓 🍁
楓葉	楓葉 🍁
楓葉之國	楓葉之國 🇨🇦
蜂	蜂 🐝
蜂蜜	蜂蜜 🍯
蜂蜜罐	蜂蜜罐 🍯
豐收	豐收 🎑
凤梨	凤梨 🍍
鳳梨	鳳梨 🍍
佛得角	佛得角 🇨🇻
佛殿	佛殿 🛐
佛堂	佛堂 🛐
佛珠	佛珠 📿
夫妇	夫妇 👫 💑 👫🏻
夫婦	夫婦 👫 💑 👫🏻
夫妻	夫妻 👫 👫🏻
肤色	肤色 🏻 🏼 🏽 🏾 🏿
孵化	孵化 🐣
孵化器	孵化器 🐣
孵小鸡	孵小鸡 🐣
孵小雞	孵小雞 🐣
膚色	膚色 🏻 🏼 🏽 🏾 🏿
伏	伏 ㎴ ㎵ ㎶ ㎷ ㎸
伏特	伏特 ㎴ ㎵ ㎶ ㎷ ㎸
扶桑	扶桑 🌼
扶桑花	扶桑花 🌺
芙蓉	芙蓉 🌺
服务费	服务费 🈂
服务犬	服务犬 🦮 🐕‍🦺
服务员	服务员 💁 💁🏻‍♀ 💁🏻‍♂ 💁🏻
服務員	服務員 💁 💁🏻‍♀ 💁🏻‍♂ 💁🏻
服装	服装 🎩 👑 👒 👓 👔 👕 👖 👗 👘 👙 👚 👛 👜 👝 👞 👟 👠 👡 👢 🧥 👚 👕 👖 🩳 👔 👗 👘 🥻 🩲 👙 🩱 🥼
服裝	服裝 🎩 👑 👒 👓 👔 👕 👖 👗 👘 👙 👚 👛 👜 👝 👞 👟 👠 👡 👢 🧥 👚 👕 👖 🩳 👔 👗 👘 🥻 🩲 👙 🩱 🥼
浮云	浮云 ☁
浮雲	浮雲 ☁
符号	符号 🔣 © ® ‼ ⁉ ™ ℹ ↔ ↕ ↖ ↗ ↘ ↙ ↩ ↪ ⏫ ⏬ Ⓜ ☑ ♻ ⚓ ✔ ✖ ✳ ✴ ❌ ❎ ❓ ❔ ❕ ❗ ❤ ➕ ➡ ⤴ ⤵ ⬅ ⬆ ⬇ ⭐ ⭕ 〰 〽 ㊗ ㊙ 🆑 🆒 🆓 🆔 🆕 🆖 🆗 🆘 🆙 🆚 🈚 🈯 🈲 🈳 🈴 🈵 🈶 🈷 🈸 🈹 🈺 🉐 🉑 🔀 🔁 🔂 🔄 🔙 🔚 🔛 🔜 🔝 🔟 🔠 🔡 🔢 🔤 🔮 🔯 🔰 🔱 🔼 🔽
符号键盘	符号键盘 🔣
符號	符號 © ® ‼ ⁉ ™ ℹ ↔ ↕ ↖ ↗ ↘ ↙ ↩ ↪ ⏫ ⏬ Ⓜ ☑ ♻ ⚓ ✔ ✖ ✳ ✴ ❌ ❎ ❓ ❔ ❕ ❗ ❤ ➕ ➡ ⤴ ⤵ ⬅ ⬆ ⬇ ⭐ ⭕ 〰 〽 ㊗ ㊙ 🆑 🆒 🆓 🆔 🆕 🆖 🆗 🆘 🆙 🆚 🈚 🈯 🈲 🈳 🈴 🈵 🈶 🈷 🈸 🈹 🈺 🉐 🉑 🔀 🔁 🔂 🔄 🔙 🔚 🔛 🔜 🔝 🔟 🔠 🔡 🔢 🔣 🔤 🔮 🔯 🔰 🔱 🔼 🔽
符號鍵盤	符號鍵盤 🔣
辐射	辐射 ☢ ☢️ 🩻
福克兰群岛	福克兰群岛 🇫🇰
福克蘭群島	福克蘭群島 🇫🇰
蝠	蝠 🦇
輻射	輻射 ☢ ☢️ 🩻
斧子	斧子 🪓
父	父 👨 👨🏻 👨🏻
父女	父女 👨‍👧
父女俩	父女俩 👨‍👧
父女倆	父女倆 👨‍👧
父亲	父亲 👨 👨🏻 👨🏻
父親	父親 👨 👨🏻 👨🏻
父子	父子 👨‍👦
父子俩	父子俩 👨‍👦
父子倆	父子倆 👨‍👦
驸马	驸马 🤴🏻
复活节岛	复活节岛 🗿
复选框	复选框 ☑ ☑️
复杂	复杂 🤔
富士山	富士山 🗻
複選框	複選框 ☑ ☑️
複雜	複雜 🤔
駙馬	駙馬 🤴🏻
盖饭	盖饭 🍛 🥘
盖亚那	盖亚那 🇬🇾
蓋飯	蓋飯 🍛 🥘
蓋亞那	蓋亞那 🇬🇾
甘比亚	甘比亚 🇬🇲
甘比亞	甘比亞 🇬🇲
柑橘	柑橘 🍊
尴尬	尴尬 😅
尷尬	尷尬 😅
感动	感动 😹 🥹
感動	感動 😹 🥹
感恩节	感恩节 🦃
感恩節	感恩節 🦃
感激不尽	感激不尽 🙏 🙏🏻 🙏🏻
感激不盡	感激不盡 🙏 🙏🏻 🙏🏻
感冒	感冒 🤒 🤧 😷 🤧
感情	感情 💑 💑🏻
感谢	感谢 🙏 🙏🏻 🙏🏼 🙏🏽 🙏🏾 🙏🏿 🙏🏻
感謝	感謝 🙏 🙏🏻 🙏🏻
橄榄球	橄榄球 🏈 🏉 🏉
橄榄之国	橄榄之国 🇹🇳
橄榄枝	橄榄枝 🕊 🕊️
橄欖球	橄欖球 🏈 🏉 🏉
橄欖之國	橄欖之國 🇹🇳
橄欖枝	橄欖枝 🕊 🕊️
干杯	干杯 🥂 🍻 🥂
冈比亚	冈比亚 🇬🇲
刚果	刚果 🇨🇩 🇨🇬 🇨🇬
刚果共和国	刚果共和国 🇨🇬
刚果金	刚果金 🇨🇩
刚果民主共和国	刚果民主共和国 🇨🇩
岡比亞	岡比亞 🇬🇲
钢笔	钢笔 ✒ 🖋 ✒️ 🖋️
钢琴	钢琴 🎹
剛果	剛果 🇨🇬
剛果共和國	剛果共和國 🇨🇬
剛果金	剛果金 🇨🇩
剛果民主共和國	剛果民主共和國 🇨🇩
鋼筆	鋼筆 ✒ 🖋 ✒️ 🖋️
鋼琴	鋼琴 🎹
港口	港口 ⚓
杠铃	杠铃 🏋 🏋🏻‍♀ 🏋🏻‍♂ 🏋🏻
槓鈴	槓鈴 🏋 🏋🏻‍♀ 🏋🏻‍♂ 🏋🏻
戆居	戆居 🐷
高度	高度 ↕ ↕️
高尔夫	高尔夫 🏌‍♂ 🏌 🏌‍♀ ⛳ 🏌🏻‍♂ 🏌🏼‍♂ 🏌🏽‍♂ 🏌🏾‍♂ 🏌🏿‍♂ 🏌🏻 🏌🏼 🏌🏽 🏌🏾 🏌🏿 🏌🏻‍♀ 🏌🏼‍♀ 🏌🏽‍♀ 🏌🏾‍♀ 🏌🏿‍♀ ⛳️ 🏌🏻
高尔夫球	高尔夫球 ⛳ 🏌 🏌🏻‍♀ 🏌🏻‍♂ 🏌🏻
高爾夫	高爾夫 ⛳ 🏌 🏌🏻‍♀ 🏌🏻‍♂ ⛳️ 🏌🏻
高爾夫球	高爾夫球 ⛳ 🏌 🏌🏻‍♀ 🏌🏻‍♂ 🏌🏻
高跟鞋	高跟鞋 👠
高卢雄鸡	高卢雄鸡 🇫🇷
高盧雄雞	高盧雄雞 🇫🇷
高帽	高帽 🎩
高烧	高烧 🤒
高燒	高燒 🤒
高速	高速 🛣 🛣️
高速公路	高速公路 🛣 🛣️
高速列车	高速列车 🚄 🚅
高速列車	高速列車 🚄 🚅
高速路	高速路 🛣 🛣️
高铁	高铁 🚄 🚅 🚄
高鐵	高鐵 🚄 🚅 🚄
高温	高温 🥵
高溫	高溫 🥵
高兴	高兴 😊 😀 😁 😃 😄 😸 😺 🕺🏻 🥳 🕺🏻 😊 😺 🥳
高興	高興 😀 😃 😄 😊 😸 😺 🕺🏻 🥳 🕺🏻 😊 😺 🥳
高压	高压 ⚡ ⚡️
高压电	高压电 ⚡ ⚡️
高壓	高壓 ⚡ ⚡️
高壓電	高壓電 ⚡ ⚡️
高音量	高音量 🔊
高原雄鹰	高原雄鹰 🇲🇽
高原雄鷹	高原雄鷹 🇲🇽
高中	高中 🏫
糕点	糕点 🍰
糕點	糕點 🍰
镐	镐 ⛏ ⛏️
鎬	鎬 ⛏ ⛏️
哥布林	哥布林 👺
哥弟	哥弟 👬 👬🏻
哥俩	哥俩 👬 👬🏻
哥俩好	哥俩好 👬 👬🏻
哥倆	哥倆 👬 👬🏻
哥倆好	哥倆好 👬 👬🏻
哥伦比亚	哥伦比亚 🇨🇴
哥倫比亞	哥倫比亞 🇨🇴
哥妹	哥妹 👫 👫🏻
哥斯达黎加	哥斯达黎加 🇨🇷
哥斯達黎加	哥斯達黎加 🇨🇷
哥斯大黎加	哥斯大黎加 🇨🇷
胳膊	胳膊 💪 🦾 💪🏻 💪🏼 💪🏽 💪🏾 💪🏿
鸽	鸽 🕊 🐦 🕊️
鸽子	鸽子 🕊 🐦 🕊️
割	割 🈹 🈹️
歌记号	歌记号 〽
歌記號	歌記號 〽
歌手	歌手 👨‍🎤 🧑‍🎤 👩‍🎤 👨🏻‍🎤 👨🏼‍🎤 👨🏽‍🎤 👨🏾‍🎤 👨🏿‍🎤 🧑🏻‍🎤 🧑🏼‍🎤 🧑🏽‍🎤 🧑🏾‍🎤 🧑🏿‍🎤 👩🏻‍🎤 👩🏼‍🎤 👩🏽‍🎤 👩🏾‍🎤 👩🏿‍🎤 🧑🏻‍🎤️
歌星	歌星 👨🏻‍🎤 👩🏻‍🎤 🧑🏻‍🎤️
歌谣开始记号	歌谣开始记号 〽
歌謠開始記號	歌謠開始記號 〽
鴿	鴿 🕊 🕊️
鴿子	鴿子 🕊 🕊️
格尺	格尺 📏
格恩济	格恩济 🇬🇬
格恩濟	格恩濟 🇬🇬
格林纳达	格林纳达 🇬🇩
格林納達	格林納達 🇬🇩
格陵兰	格陵兰 🇬🇱
格陵蘭	格陵蘭 🇬🇱
格鲁吉亚	格鲁吉亚 🇬🇪
格魯吉亞	格魯吉亞 🇬🇪
格瑞那达	格瑞那达 🇬🇩
格瑞那達	格瑞那達 🇬🇩
格子军	格子军 🇭🇷
格子軍	格子軍 🇭🇷
格子旗	格子旗 🏁
葛摩	葛摩 🇰🇲
个人	个人 👤
個人	個人 👤
给钱	给钱 🤑
給錢	給錢 🤑
给你	给你 ୧⍤⃝ 
根号	根号 √ ∛ ∜
根西	根西 🇬🇬
艮	艮 ☶
耿西	耿西 🇬🇬
工厂	工厂 🏭
工廠	工廠 🏭
工程师	工程师 👷 👨🏻‍💻 👩🏻‍💻 👷🏻‍♀ 👷🏻‍♂ 👷🏻 🧑🏻‍💻
工程師	工程師 👷 👨🏻‍💻 👩🏻‍💻 👷🏻‍♀ 👷🏻‍♂ 👷🏻 🧑🏻‍💻
工地	工地 🏗 🏗️
工具	工具 ✂ 🔋 🔌 🔍 🔎 🔏 🔐 🔑 🔒 🔓 🔔 🔖 🔗 🔘 🔦 🔧 🔨 🔩 🔪 🔫 🔬 🔭 🛠 ⚙️ 🔩 ⛏ 🛠 ⚒️ 🔨 🔧 ⛓ 🧰 🪒 🪚 🪛 🪜 🪡
工具盒	工具盒 🛠 🛠️
工具箱	工具箱 🧰 🛠 🛠️ 🧰
工人	工人 👨‍🔧 👩‍🔧 🧑‍🔧 👨‍🏭 🧑‍🏭 👩‍🏭 👨🏻‍🔧 👨🏼‍🔧 👨🏽‍🔧 👨🏾‍🔧 👨🏿‍🔧 🧑🏻‍🔧 🧑🏼‍🔧 🧑🏽‍🔧 🧑🏾‍🔧 🧑🏿‍🔧 👩🏻‍🔧 👩🏼‍🔧 👩🏽‍🔧 👩🏾‍🔧 👩🏿‍🔧 👨🏻‍🏭 👨🏼‍🏭 👨🏽‍🏭 👨🏾‍🏭 👨🏿‍🏭 🧑🏻‍🏭 🧑🏼‍🏭 🧑🏽‍🏭 🧑🏾‍🏭 🧑🏿‍🏭 👩🏻‍🏭 👩🏼‍🏭 👩🏽‍🏭 👩🏾‍🏭 👩🏿‍🏭 👷 👷🏻‍♀ 👷🏻‍♂ 👷🏻 🧑🏻‍🏭
工薪阶层	工薪阶层 👨🏻‍💼 👩🏻‍💼 🧑🏻‍💼
工薪階層	工薪階層 👨🏻‍💼 👩🏻‍💼 🧑🏻‍💼
工业区	工业区 🏭
工業區	工業區 🏭
工字釘	工字釘 📌
工字钉	工字钉 📌
弓	弓 🏹
弓箭	弓箭 🏹
公车	公车 🚌 🚍 🚎 🚐 🚌
公车站	公车站 🚏
公車	公車 🚌 🚍 🚎 🚐 🚌
公車站	公車站 🚏
公放	公放 📢
公共汽车	公共汽车 🚌 🚍 🚎 🚐
公共汽车站	公共汽车站 🚏
公共汽車	公共汽車 🚌 🚍 🚎 🚐
公共汽車站	公共汽車站 🚏
公共小巴	公共小巴 🚐
公鸡	公鸡 🐓
公雞	公雞 🐓
公交	公交 🚌 🚍 🚎 🚐 🚏 🚈 🚇 🚊 🚌 🚎 🚍 🚈 🚇 🚊
公交车	公交车 🚌
公交车站	公交车站 🚏
公交車	公交車 🚌
公交車站	公交車站 🚏
公路	公路 🛣
公牛	公牛 🐂
公顷	公顷 ㌶
公事包	公事包 💼
公文包	公文包 💼
公羊	公羊 🐏
公园	公园 🏞 ⛲ ⛲️
公園	公園 ⛲ ⛲️
公猪	公猪 🐗
公豬	公豬 🐗
公主	公主 👸 👸🏻 👸🏼 👸🏽 👸🏾 👸🏿 👸🏻
功率	功率 ㎺ ㎻ ㎼ ㎽ ㎾
宫灯	宫灯 🏮
恭贺	恭贺 ㊗
恭賀	恭賀 ㊗
宮燈	宮燈 🏮
共产党	共产党 ☭
共产主义	共产主义 ☭
勾	勾 ✅ ✔ ✅ ✔️ 🪝
勾选	勾选 ☑ ✅ ✅
勾選	勾選 ☑ ✅ ✅
狗	狗 🐕 🐩 🐶 🦮 🐕‍🦺 🐕 🐩
狗狗	狗狗 🐩
狗脸	狗脸 🐶
狗臉	狗臉 🐶
狗年	狗年 🐶
狗娘养的	狗娘养的 🤬
狗孃養的	狗孃養的 🤬
狗日的	狗日的 🤬
狗肉	狗肉 🐕
狗屎	狗屎 💩
狗头	狗头 🐶
狗頭	狗頭 🐶
狗杂种	狗杂种 🤬
狗雜種	狗雜種 🤬
购物	购物 🛒 🛍 🛍️
购物车	购物车 🛒
购物袋	购物袋 🛍 🛍️
購物	購物 🛍 🛍️
購物車	購物車 🛒
購物袋	購物袋 🛍 🛍️
估吓	估吓 😏
古巴	古巴 🇨🇺
古堡	古堡 🏰
骨	骨 🦴 💀 🦴
骨灰	骨灰 ⚱ ⚱️
骨灰瓶	骨灰瓶 ⚱ ⚱️
骨头	骨头 🦴 💀 ☠ 🦴
骨头肉	骨头肉 🍖
骨頭	骨頭 🦴
骨頭肉	骨頭肉 🍖
鼓	鼓 🥁
鼓掌	鼓掌 👏 👏🏻 👏🏼 👏🏽 👏🏾 👏🏿 👏🏻
鼔	鼔 🥁
鼔点	鼔点 🥁
鼔點	鼔點 🥁
瓜	瓜 🍈 🍉 🎃
瓜德罗普	瓜德罗普 🇬🇵
瓜德羅普	瓜德羅普 🇬🇵
瓜地洛普	瓜地洛普 🇬🇵
瓜地马拉	瓜地马拉 🇬🇹
瓜地馬拉	瓜地馬拉 🇬🇹
瓜皮帽	瓜皮帽 👲 👲🏻 👲🏻
挂历	挂历 🗓 🗓️
掛曆	掛曆 🗓 🗓️
乖	乖 😬
乖孩子	乖孩子 🤓
怪兽	怪兽 👾
怪獸	怪獸 👾
怪物	怪物 👹 👺 🤖 👾 🦄 🦄 🤖 👾 👹 👺
关岛	关岛 🇬🇺
关东煮	关东煮 🍢
关机	关机 📴
关机模式	关机模式 📴
观察	观察 🧐
观光列车	观光列车 🚟
观赏鱼	观赏鱼 🐠
棺	棺 ⚰ ⚰️
棺材	棺材 ⚱ ⚰️
關島	關島 🇬🇺
關東煮	關東煮 🍢
關機	關機 📴
關機模式	關機模式 📴
觀光列車	觀光列車 🚟
觀賞魚	觀賞魚 🐠
冠军	冠军 🥇 🏆 🏆 🥇
冠軍	冠軍 🏆 🥇
灌木	灌木 🌳
罐头	罐头 🥫
罐頭	罐頭 🥫
光碟	光碟 💽 💿 📀 💿
光明	光明 🌞
光明节	光明节 🕎
光明節	光明節 🕎
光盘	光盘 💿 📀 💿
光盤	光盤 💿 📀 💿
光头	光头 👨‍🦲 🧑‍🦲 👩‍🦲 👨🏻‍🦲 👨🏼‍🦲 👨🏽‍🦲 👨🏾‍🦲 👨🏿‍🦲 🧑🏻‍🦲 🧑🏼‍🦲 🧑🏽‍🦲 🧑🏾‍🦲 🧑🏿‍🦲 👩🏻‍🦲 👩🏼‍🦲 👩🏽‍🦲 👩🏾‍🦲 👩🏿‍🦲 🧑🏻‍🦲
光頭	光頭 👨🏻‍🦲 👩🏻‍🦲 🧑🏻‍🦲
广播	广播 📢 📻
廣播	廣播 📢 📻
圭亚那	圭亚那 🇬🇾
圭亞那	圭亞那 🇬🇾
龟	龟 🐢 𓆉 🐢
闺蜜情谊	闺蜜情谊 👩‍❤‍👩
閨蜜情誼	閨蜜情誼 👩‍❤‍👩
龜	龜 🐢
轨道车	轨道车 🚝
轨迹球	轨迹球 🖲 🖲️
诡计	诡计 🌚 😏
軌道車	軌道車 🚝
軌跡球	軌跡球 🖲 🖲️
鬼	鬼 👻 👹 👺 👻
鬼怪	鬼怪 👹 👺 👻 👹
鬼话	鬼话 🙄
鬼话连篇	鬼话连篇 🙄
鬼話	鬼話 🙄
鬼話連篇	鬼話連篇 🙄
鬼魂	鬼魂 👻
鬼火	鬼火 😡 👿 👿 😡
鬼脸	鬼脸 👻 👿 😜 🤪 🥴 🤪 🥴
鬼臉	鬼臉 👻 👿 😜 🤪 🥴 🤪 🥴
詭計	詭計 🌚 😏
贵宾狗	贵宾狗 🐩
贵宾犬	贵宾犬 🐩
貴賓狗	貴賓狗 🐩
貴賓犬	貴賓犬 🐩
跪	跪 🧎‍♂ 🧎‍♀ 🧎 🧎🏻‍♂ 🧎🏼‍♂ 🧎🏽‍♂ 🧎🏾‍♂ 🧎🏿‍♂ 🧎🏻‍♀ 🧎🏼‍♀ 🧎🏽‍♀ 🧎🏾‍♀ 🧎🏿‍♀ 🧎🏻 🧎🏼 🧎🏽 🧎🏾 🧎🏿 🧎🏻
跪拜	跪拜 🙇 🙇🏻‍♀ 🙇🏻‍♂ 🙇🏻 🧎🏻
滚	滚 😛 🤬
滚粗	滚粗 🤬
滚犊子	滚犊子 😛
滾	滾 😛 🤬
滾粗	滾粗 🤬
滾犢子	滾犢子 😛
棍网球	棍网球 🥍
棍網球	棍網球 🥍
锅	锅 🍳 🥘 🍲 🥣
锅贴	锅贴 🥟
蝈蝈	蝈蝈 🦗
鍋貼	鍋貼 🥟
蟈蟈	蟈蟈 🦗
国际	国际 🌐 🌐️
国际象棋	国际象棋 ♔ ♕ ♖ ♗ ♘ ♙ ♚ ♛ ♜ ♝ ♞ ♟ ♟️
国家公园	国家公园 🏞 🏞️
国民党	国民党 ❂
国旗	国旗 🏳 🏴 🏁 🇦 🇧 🇨 🇩 🇪 🇫 🇬 🇭 🇮 🇯 🇰 🇱 🇲 🇳 🇴 🇵 🇶 🇷 🇸 🇹 🇺 🇻 🇼 🇽 🇾 🇿 🇨🇳 🇺🇸 🇷🇺 🇯🇵 🇰🇷 🇺🇳 🇬🇧 🏳‍🌈 🇦🇫 🇦🇽 🇦🇱 🇩🇿 🇦🇸 🇦🇩 🇦🇴 🇦🇮 🇦🇶 🇦🇬 🇦🇷 🇦🇲 🇦🇼 🇦🇺 🇦🇹 🇦🇿 🇧🇸 🇧🇭 🇧🇩 🇧🇧 🇧🇾 🇧🇪 🇧🇿 🇧🇯 🇧🇲 🇧🇹 🇧🇴 🇧🇦 🇧🇼 🇧🇷 🇮🇴 🇻🇬 🇧🇳 🇧🇬 🇧🇫 🇧🇮 🇰🇭 🇨🇲 🇨🇦 🇮🇨 🇨🇻 🇧🇶 🇰🇾 🇨🇫 🇹🇩 🇨🇱 🇨🇽 🇨🇨 🇨🇴 🇰🇲 🇨🇬 🇨🇩 🇨🇰 🇨🇷 🇨🇮 🇭🇷 🇨🇺 🇨🇼 🇨🇾 🇨🇿 🇩🇰 🇩🇯 🇩🇲 🇩🇴 🇪🇨 🇪🇬 🇸🇻 🇬🇶 🇪🇷 🇪🇪 🇪🇹 🇪🇺 🇫🇰 🇫🇴 🇫🇯 🇫🇮 🇫🇷 🇬🇫 🇵🇫 🇹🇫 🇬🇦 🇬🇲 🇬🇪 🇩🇪 🇬🇭 🇬🇮 🇬🇷 🇬🇱 🇬🇩 🇬🇵 🇬🇺 🇬🇹 🇬🇬 🇬🇳 🇬🇼 🇬🇾 🇭🇹 🇭🇳 🇭🇺 🇮🇸 🇮🇳 🇮🇩 🇮🇷 🇮🇶 🇮🇪 🇮🇲 🇮🇱 🇮🇹 🇯🇲 🎌 🇯🇪 🇯🇴 🇰🇿 🇰🇪 🇰🇮 🇽🇰 🇰🇼 🇰🇬 🇱🇦 🇱🇻 🇱🇧 🇱🇸 🇱🇷 🇱🇾 🇱🇮 🇱🇹 🇱🇺 🇲🇰 🇲🇬 🇲🇼 🇲🇾 🇲🇻 🇲🇱 🇲🇹 🇲🇭 🇲🇶 🇲🇷 🇲🇺 🇾🇹 🇲🇽 🇫🇲 🇲🇩 🇲🇨 🇲🇳 🇲🇪 🇲🇸 🇲🇦 🇲🇿 🇲🇲 🇳🇦 🇳🇷 🇳🇵 🇳🇱 🇳🇨 🇳🇿 🇳🇮 🇳🇪 🇳🇬 🇳🇺 🇳🇫 🇰🇵 🇲🇵 🇳🇴 🇴🇲 🇵🇰 🇵🇼 🇵🇸 🇵🇦 🇵🇬 🇵🇾 🇵🇪 🇵🇭 🇵🇳 🇵🇱 🇵🇹 🇵🇷 🇶🇦 🇷🇪 🇷🇴 🇷🇼 🇼🇸 🇸🇲 🇸🇹 🇸🇦 🇸🇳 🇷🇸 🇸🇨 🇸🇱 🇸🇬 🇸🇽 🇸🇰 🇸🇮 🇬🇸 🇸🇧 🇸🇴 🇿🇦 🇸🇸 🇪🇸 🇱🇰 🇧🇱 🇸🇭 🇰🇳 🇱🇨 🇵🇲 🇻🇨 🇸🇩 🇸🇷 🇸🇿 🇸🇪 🇨🇭 🇸🇾 🇹🇯 🇹🇿 🇹🇭 🇹🇱 🇹🇬 🇹🇰 🇹🇴 🇹🇹 🇹🇳 🇹🇷 🇹🇲 🇹🇨 🇹🇻 🇻🇮 🇺🇬 🇺🇦 🇦🇪 🇺🇾 🇺🇿 🇻🇺 🇻🇦 🇻🇪 🇻🇳 🇼🇫 🇪🇭 🇾🇪 🇿🇲 🇿🇼
国王	国王 🤴 🤴🏻 🤴🏼 🤴🏽 🤴🏾 🤴🏿
國際	國際 🌐 🌐️
國際象棋	國際象棋 ♟ ♟️
國家公園	國家公園 🏞 🏞️
果冻	果冻 🍮
果酒	果酒 🍸
果岭	果岭 ⛳ ⛳️
果嶺	果嶺 ⛳ ⛳️
果汁	果汁 🍹 🍹 🧃
裹头	裹头 👳 👳🏻‍♀ 👳🏻‍♂ 👳🏾
裹頭	裹頭 👳 👳🏻‍♀ 👳🏻‍♂ 👳🏾
过山车	过山车 🎢
過山車	過山車 🎢
哈	哈 😄 😸
哈哈哈	哈哈哈 🤣
哈哈哈哈	哈哈哈哈 🤣
哈雷彗星	哈雷彗星 ☄ ☄️
哈密瓜	哈密瓜 🍈
哈欠	哈欠 🥱
哈萨克	哈萨克 🇰🇿
哈萨克斯坦	哈萨克斯坦 🇰🇿
哈薩克	哈薩克 🇰🇿
哈薩克斯坦	哈薩克斯坦 🇰🇿
蛤	蛤 🤓 🐸 𓆏
蛤蟆	蛤蟆 🐸
还好	还好 😅
孩子	孩子 👦 👧 🧒🏻 🧒🏻
海	海 🏖 ⛱ 🐚 🌊 👙
海贝	海贝 🐚
海貝	海貝 🐚
海边	海边 🏖 ⛱ 🐚 🌊 👙 🏖️
海邊	海邊 🏖 🏖️
海产	海产 🐟
海產	海產 🐟
海岛	海岛 🏝 🏝️
海島	海島 🏝 🏝️
海盗	海盗 🏴‍☠ 🏴‍☠️
海盗旗	海盗旗 🏴‍☠ 🏴‍☠️
海盜	海盜 🏴‍☠ 🏴‍☠️
海盜旗	海盜旗 🏴‍☠ 🏴‍☠️
海底世界	海底世界 🐳
海地	海地 🇭🇹
海关	海关 🛃
海關	海關 🛃
海龟	海龟 𓆉
海浪	海浪 🌊
海螺	海螺 🐚
海绵	海绵 🧽
海绵擦	海绵擦 🧽
海綿	海綿 🧽
海綿擦	海綿擦 🧽
海上活动	海上活动 ⛵
海上活動	海上活動 ⛵
海上日出	海上日出 🌅
海滩	海滩 🏖 🏖️
海滩伞	海滩伞 ⛱
海滩阳伞	海滩阳伞 ⛱
海灘	海灘 🏖 🏖️
海灘傘	海灘傘 ⛱
海灘陽傘	海灘陽傘 ⛱
海棠	海棠 🌺
海豚	海豚 🐬
海王戟	海王戟 🔱
海鲜	海鲜 🐟
海鮮	海鮮 🐟
海啸	海啸 🌊
海嘯	海嘯 🌊
海洋世界	海洋世界 🐳
海运	海运 ⚓ 🚢
海運	海運 ⚓ 🚢
害怕	害怕 😨 😱
害臊	害臊 😳
害羞	害羞 ☺ 😊 😚 😳 🙈 ☺️ 😚 🙈
酣睡	酣睡 💤
憨	憨 🐷
含蓄	含蓄 ☺ ☺️
韩	韩 ㄱ ㄲ ㄳ ㄴ ㄵ ㄶ ㄷ ㄸ ㄹ ㄺ ㄻ ㄼ ㄽ ㄾ ㄿ ㅀ ㅁ ㅂ ㅃ ㅄ ㅅ ㅆ ㅇ ㅈ ㅉ ㅊ ㅋ ㅌ ㅍ ㅎ ㅏ ㅐ ㅑ ㅒ ㅓ ㅔ ㅕ ㅖ ㅗ ㅘ ㅙ ㅚ ㅛ ㅜ ㅝ ㅞ ㅟ ㅠ ㅡ ㅢ ㅥ ㅦ ㅧ ㅨ ㅩ ㅪ ㅫ ㅬ ㅭ ㅮ ㅯ ㅰ ㅱ ㅲ ㅳ ㅴ ㅵ ㅶ ㅷ ㅸ ㅹ ㅺ ㅻ ㅼ ㅽ ㅾ ㅿ ㆀ ㆁ ㆂ ㆃ ㆄ ㆅ ㆆ ㆇ ㆈ ㆉ ㆊ
韩国	韩国 🇰🇷
韩国国旗	韩国国旗 🇰🇷
韩语	韩语 ㄱ ㄲ ㄳ ㄴ ㄵ ㄶ ㄷ ㄸ ㄹ ㄺ ㄻ ㄼ ㄽ ㄾ ㄿ ㅀ ㅁ ㅂ ㅃ ㅄ ㅅ ㅆ ㅇ ㅈ ㅉ ㅊ ㅋ ㅌ ㅍ ㅎ ㅏ ㅐ ㅑ ㅒ ㅓ ㅔ ㅕ ㅖ ㅗ ㅘ ㅙ ㅚ ㅛ ㅜ ㅝ ㅞ ㅟ ㅠ ㅡ ㅢ ㅥ ㅦ ㅧ ㅨ ㅩ ㅪ ㅫ ㅬ ㅭ ㅮ ㅯ ㅰ ㅱ ㅲ ㅳ ㅴ ㅵ ㅶ ㅷ ㅸ ㅹ ㅺ ㅻ ㅼ ㅽ ㅾ ㅿ ㆀ ㆁ ㆂ ㆃ ㆄ ㆅ ㆆ ㆇ ㆈ ㆉ ㆊ
韩元	韩元 ₩
韩圆	韩圆 💴
寒冷	寒冷 🥶 ❄️ 🌨 ☃️ ⛄ 🧊
韓國	韓國 🇰🇷
韓國國旗	韓國國旗 🇰🇷
韓圓	韓圓 💴
喊	喊 🗣 🗣️
喊话	喊话 🗣 🗣️
喊話	喊話 🗣 🗣️
汉堡	汉堡 🍔
汉堡包	汉堡包 🍔
汉服	汉服 👘
汗	汗 😓 💦 😅 😥 😰 😿 😓 😢 😥 😿
汗滴	汗滴 💧
汗水	汗水 💦
汗颜	汗颜 💧 😓
汗顏	汗顏 💧 😓
漢堡	漢堡 🍔
漢堡包	漢堡包 🍔
漢服	漢服 👘
行	行 🙆‍♂ 🙆 🙆‍♀ 👌 👍 🆗 🙆🏻‍♂ 🙆🏼‍♂ 🙆🏽‍♂ 🙆🏾‍♂ 🙆🏿‍♂ 🙆🏻 🙆🏼 🙆🏽 🙆🏾 🙆🏿 🙆🏻‍♀ 🙆🏼‍♀ 🙆🏽‍♀ 🙆🏾‍♀ 🙆🏿‍♀ 👌🏻 👌🏼 👌🏽 👌🏾 👌🏿 👍🏻 👍🏼 👍🏽 👍🏾 👍🏿 😎 🆗️ 👌🏻 😎
行啊	行啊 😉
行动电话	行动电话 📱
行動電話	行動電話 📱
行李	行李 🧳 🛄 🛄 🧳
行李过机	行李过机 🛄
行李過機	行李過機 🛄
行李检查	行李检查 🛃
行李檢查	行李檢查 🛃
行李通查	行李通查 🛄
行李托管	行李托管 🛅
行李箱	行李箱 🧳
行人	行人 🚶 🚶🏻‍♀ 🚶🏻‍♂ 🚶🏻
行人止歩	行人止歩 🚷
行走	行走 🚶‍♂ 🚶‍ 🚶‍♀ 🚶🏻‍♂ 🚶🏼‍♂ 🚶🏽‍♂ 🚶🏾‍♂ 🚶🏿‍♂ 🚶🏻 🚶🏼 🚶🏽 🚶🏾 🚶🏿 🚶🏻‍♀ 🚶🏼‍♀ 🚶🏽‍♀ 🚶🏾‍♀ 🚶🏿‍♀ 🚶 🚶🏻
航空	航空 ✈
蚝	蚝 🦪
毫克	毫克 ㎎
毫米	毫米 ㎜
豪猪	豪猪 🐗
豪豬	豪豬 🐗
好	好 🙆‍♂ 🙆 🙆‍♀ 👌 👍 🆗 🙆🏻‍♂ 🙆🏼‍♂ 🙆🏽‍♂ 🙆🏾‍♂ 🙆🏿‍♂ 🙆🏻 🙆🏼 🙆🏽 🙆🏾 🙆🏿 🙆🏻‍♀ 🙆🏼‍♀ 🙆🏽‍♀ 🙆🏾‍♀ 🙆🏿‍♀ 👌🏻 👌🏼 👌🏽 👌🏾 👌🏿 👍🏻 👍🏼 👍🏽 👍🏾 👍🏿 🙂 🆗️ 🙂
好啊	好啊 😁
好吧	好吧 😉 😪
好棒	好棒 👍 😺 👍🏻 🤩 👍🏻 🤩
好吃	好吃 😋 😍 😻
好喫	好喫 😋 😍 😻
好的	好的 👌 😉 👌🏻 👌🏻 😉
好复杂	好复杂 🤔
好複雜	好複雜 🤔
好好笑	好好笑 😆
好假	好假 😓
好劲	好劲 🤩
好勁	好勁 🤩
好囧	好囧 😅 😰
好窘	好窘 😅
好纠结	好纠结 😂 😹
好糾結	好糾結 😂 😹
好可怕	好可怕 😨
好叻	好叻 🤩
好萌	好萌 😊
好难	好难 😵 😵 😵‍💫
好难过	好难过 😩
好難	好難 😵 😵 😵‍💫
好難過	好難過 😩
好评	好评 💯
好評	好評 💯
好玩	好玩 😆
好味	好味 😋
好无聊	好无聊 😴
好無聊	好無聊 😴
好笑	好笑 😆 😆 🤭
好学生	好学生 🤓
好學生	好學生 🤓
好嘢	好嘢 👍🏻
好运	好运 🤞 🙏 🤞🏻 🤞🏼 🤞🏽 🤞🏾 🤞🏿 🙏🏻 🙏🏼 🙏🏽 🙏🏾 🙏🏿 🍀
好運	好運 🍀
好赞	好赞 👍🏻
好讚	好讚 👍🏻
号	号 🎺 📯
号角	号角 📯
號角	號角 📯
呵呵	呵呵 😄 🙃 🙃 🥲
呵护	呵护 🤲🏻
呵護	呵護 🤲🏻
喝采	喝采 🥳
喝咖啡	喝咖啡 ☕
喝醉	喝醉 🥴
合	合 🈴 🈴️
合格	合格 🈴
合掌	合掌 🙏
合作	合作 🤝 🤝🏻
和	和 & ∑ ∧
和服	和服 👘
和平	和平 ☮ 🕊 ☮️ 🕊️
和平鸽	和平鸽 🕊 🕊️
和平鴿	和平鴿 🕊 🕊️
和谐号	和谐号 🚅
和諧號	和諧號 🚅
河马	河马 🦛
河馬	河馬 🦛
河豚	河豚 🐡
荷包	荷包 👝
荷包蛋	荷包蛋 🍳
荷兰	荷兰 🇳🇱
荷蘭	荷蘭 🇳🇱
荷属阿鲁巴	荷属阿鲁巴 🇦🇼
荷属沙巴	荷属沙巴 🇧🇶
荷属圣马丁	荷属圣马丁 🇸🇽
荷屬阿魯巴	荷屬阿魯巴 🇦🇼
荷屬沙巴	荷屬沙巴 🇧🇶
荷屬聖馬丁	荷屬聖馬丁 🇸🇽
核辐射	核辐射 ☢ ☢️
核輻射	核輻射 ☢ ☢️
核突	核突 🤢 🤮
核武器	核武器 ☢ ☢️
核子	核子 ⚛ ⚛️
核子能	核子能 ⚛ ⚛️
盒饭	盒饭 🍱
盒飯	盒飯 🍱
贺礼	贺礼 🎁
賀禮	賀禮 🎁
赫兹	赫兹 ㎐ ㎑ ㎒ ㎓ ㎔
黑方	黑方 ◼ ◼️
黑旗	黑旗 🏴
黑人	黑人 👨🏿 👩🏿 👴🏿 👵🏿 👦🏿 👧🏿 👶🏿 🧓🏿 🧑🏿 🧒🏿 👶🏿
黑山	黑山 🇲🇪
黑桃	黑桃 ♠ ♤ ♠️
黑心	黑心 🖤
黑猩猩	黑猩猩 🦍
黑中有白	黑中有白 🔲
黑珠	黑珠 ⚫ ⚫️
黑子	黑子 ⚫ ⚫️
嘿嘿	嘿嘿 😈 😏 😈 😏 🤭
很棒	很棒 👍
很強	很強 👍
很强	很强 👍
哼	哼 😤 😾 🙄
横	横 一
红包	红包 🧧
红唇	红唇 💋
红发	红发 👨🏻‍🦰 👩🏻‍🦰 🧑🏻‍🦰
红酒	红酒 🍷
红酒杯	红酒杯 🍷
红萝卜	红萝卜 🥕
红绿灯	红绿灯 🚥 🚦
红玫瑰	红玫瑰 🌹
红娘	红娘 💘
红苹果	红苹果 🍎
红旗	红旗 🚩
红色书本	红色书本 📕
红薯	红薯 🍠
红桃	红桃 ♥ ♡
红心	红心 ♥ ❤ ♥️ ❤️️
红叶	红叶 🍁
红中	红中 🀄
红珠	红珠 🔴
红子	红子 🔴
宏都拉斯	宏都拉斯 🇭🇳
虹	虹 🌈
洪都拉斯	洪都拉斯 🇭🇳
紅包	紅包 🧧
紅唇	紅唇 💋
紅髮	紅髮 👨🏻‍🦰 👩🏻‍🦰 🧑🏻‍🦰
紅酒	紅酒 🍷
紅酒杯	紅酒杯 🍷
紅蘿蔔	紅蘿蔔 🥕
紅綠燈	紅綠燈 🚥 🚦
紅玫瑰	紅玫瑰 🌹
紅娘	紅娘 💘
紅蘋果	紅蘋果 🍎
紅旗	紅旗 🚩
紅色書本	紅色書本 📕
紅薯	紅薯 🍠
紅桃	紅桃 ♥
紅心	紅心 ♥ ❤ ♥️ ❤️️
紅葉	紅葉 🍁
紅中	紅中 🀄
紅珠	紅珠 🔴
紅子	紅子 🔴
猴	猴 🐵 🐒 🙈 🙉 🙊 🐒
猴脸	猴脸 🐵
猴臉	猴臉 🐵
猴年	猴年 🐵
猴头	猴头 🐵
猴頭	猴頭 🐵
猴子	猴子 🐵 🐒 🙈 🙉 🙊 🐒
猴子脸	猴子脸 🐵
猴子臉	猴子臉 🐵
后	后 🈝 ⬇ ⬇️
后退	后退 🔙
後	後 ⬇ ⬇️
後退	後退 🔙
呼	呼 ㈺
呼机	呼机 📟
呼機	呼機 📟
呼救	呼救 🆘
狐	狐 🦊
狐狸	狐狸 🦊
弧度	弧度 ㎭ ㎮ ㎯
胡扯	胡扯 🤥
胡萝卜	胡萝卜 🥕
胡蘿蔔	胡蘿蔔 🥕
胡说	胡说 🤥
胡說	胡說 🤥
蝴蝶	蝴蝶 🦋
蝴蝶饼	蝴蝶饼 🥨
蝴蝶餅	蝴蝶餅 🥨
蝴蝶脆饼	蝴蝶脆饼 🥨
蝴蝶脆餅	蝴蝶脆餅 🥨
蝴蝶结	蝴蝶结 🎀
蝴蝶結	蝴蝶結 🎀
糊涂	糊涂 🥴
糊塗	糊塗 🥴
虎	虎 🐯 🐅 🐅
虎脸	虎脸 🐯
虎臉	虎臉 🐯
虎年	虎年 🐯
虎头	虎头 🐯
虎頭	虎頭 🐯
許可	許可 🉑
許可證	許可證 🎟 🎟️
許願	許願 🎋
护目镜	护目镜 🥽
护身符	护身符 🧿
护士	护士 👨🏻‍⚕ 👩🏻‍⚕ 🧑🏻‍⚕️
护士服	护士服 🥼
護目鏡	護目鏡 🥽
護士	護士 👨🏻‍⚕ 👩🏻‍⚕ 🧑🏻‍⚕️
護士服	護士服 🥼
花	花 💐 🌸 💮 🏵 🌹 🥀 🌺 🌻 🌼 🌷 ꧁ ꧂ ࿆ ⚜ 🌸 🌺 🌼 🌻 🌷 🌹 💐 🥀 🪷
花豹	花豹 🐆
花菜	花菜 🥦
花大姐	花大姐 🐞
花朵	花朵 🌺 🌼
花瓶	花瓶 🏺
花洒	花洒 🚿
花灑	花灑 🚿
花生	花生 🥜
花束	花束 💐
花椰菜	花椰菜 🥦
花园	花园 ⛲ ⛲️
花园房	花园房 🏡
花園	花園 ⛲ ⛲️
花園房	花園房 🏡
花札	花札 🎴
花札牌	花札牌 🎴
划船	划船 🚣‍♂ 🚣 🚣‍♀ 🚣🏻‍♂ 🚣🏼‍♂ 🚣🏽‍♂ 🚣🏾‍♂ 🚣🏿‍♂ 🚣🏻 🚣🏼 🚣🏽 🚣🏾 🚣🏿 🚣🏻‍♀ 🚣🏼‍♀ 🚣🏽‍♀ 🚣🏾‍♀ 🚣🏿‍♀ 🚣🏻
划艇	划艇 🚣 🚣🏻‍♀ 🚣🏻‍♂ 🚣🏻
华氏度	华氏度 ℉
滑板	滑板 🛹 🎨 🎨 🛹
滑板车	滑板车 🛴
滑板車	滑板車 🛴
滑冰	滑冰 ⛸ ⛸️
滑动开关	滑动开关 🎚 🎚️
滑動開關	滑動開關 🎚 🎚️
滑杆	滑杆 🎚 🎚️
滑桿	滑桿 🎚 🎚️
滑稽	滑稽 😏
滑鼠	滑鼠 🖱 🖱️
滑雪	滑雪 ⛷ 🏂 🎿 ⛷️ 🏂🏻
滑雪板	滑雪板 🎿 🏂 🎿
滑雪鞋	滑雪鞋 🎿
化学	化学 ⚗ ⚗️
化学物质	化学物质 🧪
化學	化學 ⚗ ⚗️
化學物質	化學物質 🧪
化妆室	化妆室 🚻
化妝室	化妝室 🚻
化粧室	化粧室 🚻
画	画 🖼 🎨 🎨
画笔	画笔 🖌 🖌️
画画	画画 🎨
画家	画家 👨‍🎨 🧑‍🎨 👩‍🎨 👨🏻‍🎨 👨🏼‍🎨 👨🏽‍🎨 👨🏾‍🎨 👨🏿‍🎨 🧑🏻‍🎨 🧑🏼‍🎨 🧑🏽‍🎨 🧑🏾‍🎨 🧑🏿‍🎨 👩🏻‍🎨 👩🏼‍🎨 👩🏽‍🎨 👩🏾‍🎨 👩🏿‍🎨 🎨 🎨 🧑🏻‍🎨
画框	画框 🖼 🖼️
话筒	话筒 🎤 🎙 🎙️ 🎤️
畫	畫 🎨
畫筆	畫筆 🖌 🖌️
畫畫	畫畫 🎨
畫家	畫家 🎨 👨🏻‍🎨 👩🏻‍🎨 🎨 🧑🏻‍🎨
畫框	畫框 🖼 🖼️
話筒	話筒 🎙 🎤 🎙️ 🎤️
怀疑	怀疑 🤔 🤨 🥴 🧐
怀孕	怀孕 🤰🏻 🫄🏻
懷孕	懷孕 🤰🏻 🫄🏻
坏蛋	坏蛋 🦹‍♂ 🦹 🦹‍♀ 🦹🏻‍♂ 🦹🏼‍♂ 🦹🏽‍♂ 🦹🏾‍♂ 🦹🏿‍♂ 🦹🏻 🦹🏼 🦹🏽 🦹🏾 🦹🏿 🦹🏻‍♀ 🦹🏼‍♀ 🦹🏽‍♀ 🦹🏾‍♀ 🦹🏿‍♀ 🦹🏻
坏人	坏人 🦹‍♂ 🦹 🦹‍♀ 🦹🏻‍♂ 🦹🏼‍♂ 🦹🏽‍♂ 🦹🏾‍♂ 🦹🏿‍♂ 🦹🏻 🦹🏼 🦹🏽 🦹🏾 🦹🏿 🦹🏻‍♀ 🦹🏼‍♀ 🦹🏽‍♀ 🦹🏾‍♀ 🦹🏿‍♀
坏笑	坏笑 😏
壞蛋	壞蛋 🦹🏻‍♀ 🦹🏻‍♂ 🦹🏻
欢呼	欢呼 🙋 🙋🏻‍♀ 🙋🏻‍♂ 🥳 🙋🏻 🥳
欢庆	欢庆 🍾 🎊 🙌 🙌🏻 🎊 🙌🏻
欢迎	欢迎 🙋 🙋🏻‍♀ 🙋🏻‍♂ 🙋🏻
獾	獾 🦡
歡呼	歡呼 🙋 🙋🏻‍♀ 🙋🏻‍♂ 🥳 🙋🏻 🥳
歡慶	歡慶 🎊 🙌 🙌🏻 🎊 🙌🏻
歡迎	歡迎 🙋 🙋🏻‍♀ 🙋🏻‍♂ 🙋🏻
环保	环保 ♻ ♻️
环扣	环扣 🔗
環保	環保 ♻ ♻️
環扣	環扣 🔗
换汇	换汇 💱
换脸	换脸 🎭
浣熊	浣熊 🦝
換匯	換匯 💱
換臉	換臉 🎭
荒漠	荒漠 🏜 🏜️
皇储	皇储 🤴🏻
皇儲	皇儲 🤴🏻
皇冠	皇冠 👑
皇子	皇子 🤴🏻
黄蜂	黄蜂 🐝
黄瓜	黄瓜 🥒
黄昏	黄昏 🌆 🌇 🌆
黄菱	黄菱 🔶
黄色小菱形	黄色小菱形 🔸
黄色心形	黄色心形 💛
黄鼠狼	黄鼠狼 🦡
黄丝带	黄丝带 🎗 🎗️
黄心	黄心 💛
黄叶	黄叶 🍂
黄油	黄油 🧈
黄种人	黄种人 👨🏻 👩🏻 👴🏻 👵🏻 👦🏻 👧🏻 👶🏻 🧓🏻 🧑🏻 🧒🏻 👶🏻
黃蜂	黃蜂 🐝
黃瓜	黃瓜 🥒
黃昏	黃昏 🌆 🌇 🌆
黃菱	黃菱 🔶
黃色小菱形	黃色小菱形 🔸
黃鼠狼	黃鼠狼 🦡
黃絲帶	黃絲帶 🎗 🎗️
黃心	黃心 💛
黃葉	黃葉 🍂
黃種人	黃種人 👨🏻 👩🏻 👴🏻 👵🏻 👦🏻 👧🏻 👶🏻 🧓🏻 🧑🏻 🧒🏻 👶🏻
谎话	谎话 🤥
灰老鼠	灰老鼠 🐀
灰鼠	灰鼠 🐀
挥汗如雨	挥汗如雨 💦
挥拳	挥拳 👊
挥洒	挥洒 💦
挥手	挥手 🖖 👋 🖖🏻 🖖🏼 🖖🏽 🖖🏾 🖖🏿 👋🏻 👋🏼 👋🏽 👋🏾 👋🏿 👋🏻
虺	虺 🐍
揮汗如雨	揮汗如雨 💦
揮拳	揮拳 👊
揮灑	揮灑 💦
揮手	揮手 👋 👋🏻 👋🏻
回到顶部	回到顶部 🔝
回到頂部	回到頂部 🔝
回到开始	回到开始 🔚
回到開始	回到開始 🔚
回民	回民 ☪ 🧔🏻 🧕🏻 ☪️ 🧕🏾
回收	回收 ♻ ♻️
回纹针	回纹针 📎
回形针	回形针 📎
回形針	回形針 📎
回族	回族 ☪ 🧔🏻 🧕🏻 ☪️ 🧕🏾
迴紋針	迴紋針 📎
汇兑	汇兑 💱
绘画	绘画 🎨
彗星	彗星 ☄ 🌠 ☄️
匯兌	匯兌 💱
繪畫	繪畫 🎨
婚礼	婚礼 🎎 💒 💒
婚禮	婚禮 🎎 💒 💒
混乱	混乱 🙃
混亂	混亂 🙃
魂	魂 👻
魂魄	魂魄 👻
活动	活动 ⛲ ⛺ ⛽ 🀄 🃏 🎒 🎠 🎡 🎢 🎣 🎤 🎥 🎦 🎨 🎪 🎫 🎬 💄 💅 💈 💉 💊 🗽 🛀
活動	活動 ⛲ ⛺ ⛽ 🀄 🃏 🎒 🎠 🎡 🎢 🎣 🎤 🎥 🎦 🎨 🎪 🎫 🎬 💄 💅 💈 💉 💊 🗽 🛀
活火山	活火山 🌋
火	火 ㊋ ㈫ 🔥 🔥
火车	火车 🚂 🚆 🚄 🚅 🚝 🚉 🚊 🚄 🚅 🚝 🚆 🚂 🚉
火车头	火车头 🚂 🚆
火车箱	火车箱 🚆
火车站	火车站 🚉
火車	火車 🚂 🚄 🚅 🚆 🚉 🚊 🚝 🚄 🚅 🚝 🚆 🚂 🚉
火車頭	火車頭 🚂 🚆
火車箱	火車箱 🚆
火車站	火車站 🚉
火锅	火锅 🍲
火鍋	火鍋 🍲
火花	火花 ❇ 💥 ❇️ 💥
火鸡	火鸡 🦃
火雞	火雞 🦃
火箭	火箭 🚀
火警	火警 🚨 👨🏻‍🚒 👩🏻‍🚒 🚨 🧑🏻‍🚒
火烈鸟	火烈鸟 🦩
火炉国	火炉国 🇸🇩
火爐國	火爐國 🇸🇩
火苗	火苗 🔥
火山	火山 🌋
火山喷发	火山喷发 🌋
火山噴發	火山噴發 🌋
火星	火星 ✨
火焰	火焰 🔥
火著	火著 🔥
或	或 ∨
货	货 🚚
货币	货币 ₳ ฿ ₿ ￠ ₡ ¢ ₢ ₵ ₫ € ￡ £ ₤ ₣ ƒ ₲ ₭ Ł ₦ ₱ ＄ $ ₮ ℳ ₩ ￦ ¥ ￥ ₴ ¤ ₰ ៛ ₪ ₯ ₠ ₧ ﷼ 円 元 圓 ㍐ 원 ৳ ₹ ₨ ৲ ௹ 💲 💵 💶 💷 💴 💵 💶 💷 💴 💲
货币兑换	货币兑换 💱
货车	货车 🚚 🚛 🚚
货柜车	货柜车 🚜
货运	货运 🚚
获得	获得 🉐
貨	貨 🚚
貨幣	貨幣 💲 💵 💶 💷 💴 💵 💶 💷 💴 💲
貨幣兌換	貨幣兌換 💱
貨車	貨車 🚚
貨櫃車	貨櫃車 🚜
貨運	貨運 🚚
獲得	獲得 🉐
击剑	击剑 🤺
击掌	击掌 ✋ 🖐 🖐🏻 🖐🏻
击中	击中 🎯
机场	机场 ✈
机灵	机灵 😉
机器人	机器人 🤖 🦾 🦿 🤖
机械	机械 ⚙ 🔩 ⛏ 🛠 ⚒ 🔨 🔧 ⛓ 🧰 ⚙️ 🔩 ⛏ 🛠 ⚒️ 🔨 🔧 ⛓ 🧰 🪒 🪚 🪛 🪜 🪡
机长	机长 👨🏻‍✈ 👩🏻‍✈ 🧑🏻‍✈️
肌	肌 💪 💪🏻 💪🏻
肌肉	肌肉 💪 🦾 💪🏻 💪🏼 💪🏽 💪🏾 💪🏿 💪🏻
鸡	鸡 🐔 🐓 🐣 🐤 🐥 𓅱 🐓
鸡宝宝	鸡宝宝 🐤
鸡翅	鸡翅 🍗
鸡蛋	鸡蛋 🥚 🐣 🥚
鸡蛋饼	鸡蛋饼 🌮
鸡年	鸡年 🐔
鸡肉	鸡肉 🐓
鸡头	鸡头 🐔 🐤
鸡腿	鸡腿 🍗 🍖 🍖
鸡尾酒	鸡尾酒 🍸
鸡尾酒杯	鸡尾酒杯 🍸
鸡尾酒酒杯	鸡尾酒酒杯 🍸
鸡翼	鸡翼 🍗
积	积 ∏
积分	积分 ∫ ∬ ∭ ∮ ∯ ∰ ⨌
基督教	基督教 ✝ ✝️
基佬	基佬 👬 👬🏻
基里巴斯	基里巴斯 🇰🇮
基林	基林 🇨🇨
基因	基因 🧬
機長	機長 👨🏻‍✈ 👩🏻‍✈ 🧑🏻‍✈️
機場	機場 ✈
機靈	機靈 😉
機器人	機器人 🤖
機械	機械 ⚙ 🔩 ⛏ 🛠 ⚒ 🔨 🔧 ⛓ 🧰 ⚙️ 🔩 ⛏ 🛠 ⚒️ 🔨 🔧 ⛓ 🧰 🪒 🪚 🪛 🪜 🪡
擊劍	擊劍 🤺
擊掌	擊掌 ✋ 🖐 🖐🏻 🖐🏻
擊中	擊中 🎯
雞	雞 🐓 🐔 🐓
雞寶寶	雞寶寶 🐤
雞翅	雞翅 🍗
雞蛋	雞蛋 🥚
雞蛋餅	雞蛋餅 🌮
雞年	雞年 🐔
雞肉	雞肉 🐓
雞頭	雞頭 🐔 🐤
雞腿	雞腿 🍖 🍗 🍖
雞尾酒	雞尾酒 🍸
雞尾酒杯	雞尾酒杯 🍸
雞尾酒酒杯	雞尾酒酒杯 🍸
雞翼	雞翼 🍗
鷄蛋	鷄蛋 🥚
吉布地	吉布地 🇩🇯
吉布提	吉布提 🇩🇯
吉尔吉斯	吉尔吉斯 🇰🇬
吉尔吉斯斯坦	吉尔吉斯斯坦 🇰🇬
吉尔吉斯坦	吉尔吉斯坦 🇰🇬
吉爾吉斯	吉爾吉斯 🇰🇬
吉爾吉斯斯坦	吉爾吉斯斯坦 🇰🇬
吉里巴斯	吉里巴斯 🇰🇮
吉士	吉士 🍮
吉他	吉他 🎸
吉它	吉它 🎸
急救车	急救车 🚑
急救車	急救車 🚑
疾跑	疾跑 💨
几何	几何 ● ○ ◯ ◦⦿ ◉ ◎ ▷ ▸ ▹ ► ▻ ◁ ◂ ◃ ◄ ◅ ▼ ▽ ▾ ▿ ▲ △ ▴ ▵ ■ □ ▢ ▣ ◆ ◇ ◊ ◈ ❖ ❍ ◌ ◍ ◖ ◗ ◐ ◑ ◒ ◓ ◔ ◕ ◴ ◵ ◶ ◷ ◘ ◙ ◚ ◛ ▤ ▥ ▦ ▧ ▨ ▩ ◧ ◨ ◩ ◪ ◫ ◰ ◱ ◲ ◳ ▖ ▗ ▘ ▝ ▚ ▞ ▙ ▛ ▜ ▟ ❏ ❐ ❑ ❒ ❘ ❙ ❚ ▀ ▬ ▔ ▁ ▂ ▃ ▄ ▅ ▆ ▇ █ ▉ ▊ ▋ ▌ ▍ ▎ ▏ ▕ ▐ ▮ ▯ ░ ▒ ▓ ▰ ▱ ◬ ◭ ◮ ◢ ◣ ◤ ◥ ◸ ◹ ◺ ◿ ┏ ┳┓┣╋┫┗┻┛╔╦ ╗ ╠ ╬ ╣ ╚ ╩ ╝ ╓ ╥ ╖ ╟ ╫ ╢ ╙ ╨ ╜ ┌ ┬ ┐ ├ ┼ ┤ └ ┴ ┘ ╭ ╮ ╰ ╯ ━ ═ ╱ ╲ ┅ ┈ ┃ ║ ┆ ┇ ╳
几内亚	几内亚 🇬🇳
几内亚比绍	几内亚比绍 🇬🇼
几内亚比索	几内亚比索 🇬🇼
幾內亞	幾內亞 🇬🇳
幾內亞比紹	幾內亞比紹 🇬🇼
幾內亞比索	幾內亞比索 🇬🇼
幾内亞	幾内亞 🇬🇳
计程车	计程车 🚕 🚖 🚕
计时	计时 ⌛ ⏳ ⏳
计时器	计时器 ⏲ ⏲️
计算机	计算机 🖥 🖥️
记录	记录 📝
记事	记事 📝
记事簿	记事簿 📒
技工	技工 👨🏻‍🔧 👩🏻‍🔧 🧑🏻‍🔧
技师	技师 👨🏻‍🔧 👩🏻‍🔧 🧑🏻‍🔧
技師	技師 👨🏻‍🔧 👩🏻‍🔧 🧑🏻‍🔧
季军	季军 🥉
季軍	季軍 🥉
計程車	計程車 🚕 🚖 🚕
計時	計時 ⌛ ⏳ ⏳
計時器	計時器 ⏲ ⏲️
計算機	計算機 🖥 🖥️
記錄	記錄 📝
記事	記事 📝
記事簿	記事簿 📒
祭	祭 ㉀
祭典	祭典 🎆 💮 💮
寄存	寄存 🛅
寄信	寄信 📫
加	加 + ➕ ⁺ ₊ ⊕ ➕
加号	加号 ➕
加號	加號 ➕
加减	加减 ± ∓
加勒比	加勒比 🇧🇶
加密	加密 🔐
加拿大	加拿大 🇨🇦
加那利群岛	加那利群岛 🇮🇨
加那利群島	加那利群島 🇮🇨
加纳	加纳 🇬🇭
加納	加納 🇬🇭
加彭	加彭 🇬🇦
加蓬	加蓬 🇬🇦
加速	加速 ⏩
加速度	加速度 ㎨
加油	加油 ⛽ 📣 😼 😼
加油站	加油站 ⛽ ⛽️
迦纳	迦纳 🇬🇭
迦納	迦納 🇬🇭
家	家 🏠 🏡 ⌂ 🏠
家禽	家禽 🦆 🐓 🦃 🐔 🐤 🐣 🐥 🦚
家人	家人 👪 👫 👬 👭
家庭	家庭 👪 👨‍👩‍👦 👨‍👩‍👧 👨‍👩‍👧‍👦 👨‍👩‍👦‍👦 👨‍👩‍👧‍👧 👨‍👨‍👦 👨‍👨‍👧 👨‍👨‍👧‍👦 👨‍👨‍👦‍👦 👨‍👨‍👧‍👧 👩‍👩‍👦 👩‍👩‍👧 👩‍👩‍👧‍👦 👩‍👩‍👦‍👦 👩‍👩‍👧‍👧 👨‍👦 👨‍👦‍👦 👨‍👧 👨‍👧‍👦 👨‍👧‍👧 👩‍👦 👩‍👦‍👦 👩‍👧 👩‍👧‍👦 👩‍👧‍👧
家有儿女	家有儿女 👨‍👩‍👧‍👦
家有兒女	家有兒女 👨‍👩‍👧‍👦
夹子	夹子 🗜
甲虫	甲虫 𓆣 🪲
甲壳虫	甲壳虫 🐞
甲殻蟲	甲殻蟲 🐞
假话	假话 🤥
假面	假面 🎭 🎭 🥸
假笑	假笑 😏
架子鼔	架子鼔 🥁
駱駝	駱駝 🐪 🐫 🐫
奸笑	奸笑 😈
坚持	坚持 😣
坚果	坚果 🌰
坚忍	坚忍 😣
间谍	间谍 👁 🕵 🕵🏻‍♀ 🕵🏻‍♂ 👁️ 🕵🏻
间隔号	间隔号 · ‧
监	监 ㊬ ㈼
监听	监听 👁‍🗨
堅果	堅果 🌰
堅忍	堅忍 😣
間諜	間諜 👁 🕵 🕵🏻‍♀ 🕵🏻‍♂ 👁️ 🕵🏻
煎饼	煎饼 🥞
煎餅	煎餅 🥞
煎蛋	煎蛋 🍳
煎鸡蛋	煎鸡蛋 🍳
煎雞蛋	煎雞蛋 🍳
監聽	監聽 👁‍🗨
柬埔寨	柬埔寨 🇰🇭
检察	检察 🧐
减	减 - ➖ ⁻ ₋ ⊖ ➖
减号	减号 ➖
减速	减速 ⏪
剪	剪 ✂ ✂️
剪刀	剪刀 ✂ ✁ ✃ ✄ ✌ ✂️
剪发	剪发 💇 💇🏻‍♀ 💇🏻‍♂ 💇🏻
剪髮	剪髮 💇 💇🏻‍♀ 💇🏻‍♂ 💇🏻
剪辑	剪辑 🎬
剪輯	剪輯 🎬
剪切板	剪切板 📋
剪贴板	剪贴板 📋
剪貼板	剪貼板 📋
剪头发	剪头发 💇 💇🏻‍♀ 💇🏻‍♂ 💇🏻
剪頭髮	剪頭髮 💇 💇🏻‍♀ 💇🏻‍♂ 💇🏻
剪子	剪子 ✂ ✁ ✃ ✄ ✂️
減	減 ➖
減號	減號 ➖
減速	減速 ⏪
简餐	简餐 🥡
简直了	简直了 😱 🙀
檢察	檢察 🧐
簡餐	簡餐 🥡
簡直了	簡直了 😱 🙀
见鬼	见鬼 😨
见钱眼开	见钱眼开 🤑
見鬼	見鬼 😨
建设中	建设中 🏗 🏗️
建設中	建設中 🏗 🏗️
建筑	建筑 🏛 🏗 👷‍ 👷‍♂ 👷 👷‍♀ 👷🏻‍♂ 👷🏼‍♂ 👷🏽‍♂ 👷🏾‍♂ 👷🏿‍♂ 👷🏻 👷🏼 👷🏽 👷🏾 👷🏿 👷🏻‍♀ 👷🏼‍♀ 👷🏽‍♀ 👷🏾‍♀ 👷🏿‍♀ ⛪ 🏠 🏡 🏢 🏣 🏤 🏥 🏦 🏧 🏨 🏩 🏪 🏫 🏬 🏭 🏯 🏰
建筑工	建筑工 👷‍ 👷‍♂ 👷‍♀ 👷🏻‍♂ 👷🏼‍♂ 👷🏽‍♂ 👷🏾‍♂ 👷🏿‍♂ 👷🏻‍♀ 👷🏼‍♀ 👷🏽‍♀ 👷🏾‍♀ 👷🏿‍♀ 👷🏻
建筑工地	建筑工地 🏗 🏗️
建筑工人	建筑工人 👷 👷🏻‍♀ 👷🏻‍♂ 👷🏻
建築	建築 ⛪ 🏠 🏡 🏢 🏣 🏤 🏥 🏦 🏧 🏨 🏩 🏪 🏫 🏬 🏭 🏯 🏰
建築工	建築工 👷🏻‍♀ 👷🏻‍♂ 👷🏻
建築工地	建築工地 🏗 🏗️
建築工人	建築工人 👷 👷🏻‍♀ 👷🏻‍♂ 👷🏻
贱人	贱人 🤬
剑	剑 ⚔ ⚔️
舰长	舰长 👨🏻‍✈ 👩🏻‍✈ 🧑🏻‍✈️
溅	溅 💦
键板	键板 ⌨ ⌨️
键盘	键盘 ⌨ ⌨️
賤人	賤人 🤬
箭	箭 🏹
箭头	箭头 ⬆ ↗ ➡ ↘ ⬇ ↙ ⬅ ↖ ↕ ↔ ↩ ↪ ⤴ ⤵ 🔃 🔄 🔙 🔚 🔛 🔜 🔝 ↑ ⇑ ⇧ ⇡ ⇈ ↓ ⇓ ⇩ ⇣ ⇊ ← ⇐ ⇦ ⇠ ⇇ → ⇒ ⇨ ⇢ ⇉ ↵ ↳ ↰ ↱ ↶ ↷ ↺ ↻ ↚ ↛ ↮ ↜ ↝ ↞ ↟ ↠ ↡ ↢ ↣ ↤ ↥ ↦ ↧ ↨ ↫ ↬ ↭ ↯ ↲ ↴ ↸ ↹ ↼ ↽ ↾ ↿ ⇀ ⇁ ⇂ ⇃ ⇄ ⇅ ⇆ ⇋ ⇌ ⇍ ⇏ ⇔ ⇎ ⇕ ⇖ ⇗ ⇘ ⇙ ⇚ ⇛ ⇜ ⇝ ⇞ ⇟ ⇤ ⇥ ⇪ ⇫ ⇬ ⇭ ⇮ ⇯ ⇰ ⇱ ⇲ ⇳ ⇴ ⇵ ⇶ ⇷ ⇸ ⇹ ⇺ ⇻ ⇼ ⇽ ➔ ➘ ➙ ➚ ➛ ➜ ➝ ➞ ➟ ➠ ➢ ➣ ➤ ➥ ➦ ➧ ➨ ➩ ➪ ➫ ➬ ➭ ➮ ➱ ➲ ⎋ ➳ ➴ ➵ ➶ ➷ ➸ ➹ ➺ ➻ ➼ ➽ ➾ ⟰
箭頭	箭頭 ↖ ↗ ↘ ↙ ➡ ⬅ ⬆ ⬇
劍	劍 ⚔ ⚔️
鍵板	鍵板 ⌨ ⌨️
鍵盤	鍵盤 ⌨ ⌨️
濺	濺 💦
艦長	艦長 👨🏻‍✈ 👩🏻‍✈ 🧑🏻‍✈️
江豚	江豚 🐡
僵尸	僵尸 🧟‍♂ 🧟 🧟‍♀ 🧟
殭屍	殭屍 🧟‍♀ 🧟‍♂ 🧟
讲大话	讲大话 🤥
讲话	讲话 🗣 🗣️
奖	奖 🏅 🎖 🥇 🥈 🥉 🏆
奖杯	奖杯 🏆
奖牌	奖牌 🏅 🥇 🥈 🥉 🏅
奖项	奖项 🏅 🎖 🥇 🥈 🥉 🏆 🏅
奖章	奖章 🏅
獎	獎 🏅 🎖 🥇 🥈 🥉 🏆
獎杯	獎杯 🏆
獎盃	獎盃 🏆
獎牌	獎牌 🏅
獎項	獎項 🏅 🎖 🥇 🥈 🥉 🏆 🏅
獎章	獎章 🏅
講大話	講大話 🤥
講話	講話 🗣 🗣️
降低	降低 🔽
降落	降落 🛬
降落伞	降落伞 🪂
交	交 🈘 ∩
交集	交集 ∩
交通	交通 ⛵ ✈ 💺 🚀 🚁 🚂 🚃 🚄 🚅 🚇 🚈 🚉 🚊 🚌 🚍 🚎 🚏 🚐 🚑 🚒 🚓 🚔 🚕 🚖 🚗 🚘 🚙 🚚 🚜 🚝 🚞 🚟 🚠 🚡 🚢 🚣 🚤 🚥 🚦 🚧 🚨 🚲 🚴 🚶
交通标志	交通标志 🚥 🚧
交通標誌	交通標誌 🚥 🚧
交通灯	交通灯 🚥 🚦
交通燈	交通燈 🚥 🚦
交通工具	交通工具 🚄 🚌
交通号志	交通号志 🚥 🚦
交通號誌	交通號誌 🚥 🚦
胶卷	胶卷 🎞 🎞️
胶囊	胶囊 💊
胶片	胶片 🎞 🎞️
椒盐卷饼	椒盐卷饼 🥨
椒鹽捲餅	椒鹽捲餅 🥨
焦急	焦急 😰
焦虑	焦虑 😟 😰
焦糖奶油	焦糖奶油 🍮
膠卷	膠卷 🎞 🎞️
膠囊	膠囊 💊
膠片	膠片 🎞 🎞️
角	角 ∠
角色	角色 🎭 💃
狡黠	狡黠 🌝
饺	饺 🥟
饺子	饺子 🥟
脚	脚 🦶 👣 🦶🏻 🦶🏼 🦶🏽 🦶🏾 🦶🏿 🦶🏻
脚步	脚步 👣
脚底	脚底 🦶🏻
脚踏车	脚踏车 🛴 🚲
脚印	脚印 👣 🐾 🐾 👣
脚掌	脚掌 🦶🏻
搅基	搅基 👬 👬🏻
腳	腳 🦶🏻
腳步	腳步 👣
腳底	腳底 🦶🏻
腳踏車	腳踏車 🚲
腳印	腳印 🐾 👣
腳掌	腳掌 🦶🏻
餃	餃 🥟
攪基	攪基 👬 👬🏻
轿车	轿车 🚗 🚘 🚗
教师	教师 👨‍🏫 🧑‍🏫 👩‍🏫 👨🏻‍🏫 👨🏼‍🏫 👨🏽‍🏫 👨🏾‍🏫 👨🏿‍🏫 🧑🏻‍🏫 🧑🏼‍🏫 🧑🏽‍🏫 🧑🏾‍🏫 🧑🏿‍🏫 👩🏻‍🏫 👩🏼‍🏫 👩🏽‍🏫 👩🏾‍🏫 👩🏿‍🏫 🧑🏻‍🏫
教師	教師 👨🏻‍🏫 👩🏻‍🏫 🧑🏻‍🏫
教书	教书 👨🏻‍🏫 👩🏻‍🏫 🧑🏻‍🏫
教書	教書 👨🏻‍🏫 👩🏻‍🏫 🧑🏻‍🏫
教堂	教堂 ⛪ ⛪️
轎車	轎車 🚗 🚘 🚗
阶乘	阶乘 !
接地	接地 ⏚
接电话	接电话 📲
接電話	接電話 📲
接纳	接纳 👐 👐🏻 👐🏻
接納	接納 👐 👐🏻 👐🏻
接受	接受 🉑
接吻	接吻 💏 👨‍❤‍💋‍👨 👩‍❤‍💋‍👩 💋 😘 💏 😘
节	节 §
节哀	节哀 💮
节哀顺变	节哀顺变 💮
节假日	节假日 🎌
节气	节气 冬至 小寒 大寒 立春 雨水 惊蛰 春分 清明 谷雨 立夏 小满 芒种 夏至 小暑 大暑 立秋 处暑 白露 秋分 寒露 霜降 立冬 小雪 大雪
节日	节日 🎌 🎊 🎉 🪅 🎏 🎎 🏮 🎐 🧧 🎁 🧨 🎇 🎆 🎑 🎄 🧑🏻‍🎄
结构	结构 ⿰ ⿱ ⿲ ⿳ ⿴ ⿵ ⿶ ⿷ ⿸ ⿹ ⿺ ⿻ 〾
结婚	结婚 💒 ⛪ 🎎 👰 💒
结婚戒指	结婚戒指 💍
结束	结束 🔚
结业式	结业式 🎓
捷克	捷克 🇨🇿
捷运	捷运 🚇
捷運	捷運 🚇
結婚	結婚 ⛪ 🎎 👰 💒 💒
結婚戒指	結婚戒指 💍
結束	結束 🔚
結業式	結業式 🎓
節哀	節哀 💮
節哀順變	節哀順變 💮
節假日	節假日 🎌
節日	節日 🎌 🎊 🎉 🪅 🎏 🎎 🏮 🎐 🧧 🎁 🧨 🎇 🎆 🎑 🎄 🧑🏻‍🎄
姐弟	姐弟 👫 👫🏻
姐妹	姐妹 👭 👭🏻
姐妹情深	姐妹情深 👩‍❤‍👩
解	解 🈖
解锁	解锁 🔓
解鎖	解鎖 🔓
戒指	戒指 💍
借记卡	借记卡 💳
借記卡	借記卡 💳
金	金 ㊎ ㈮
金发	金发 👱 👱🏻‍♀ 👱🏻‍♂ 👱🏼
金发的人	金发的人 👱
金发男子	金发男子 👱 👱🏻‍♂
金发女郎	金发女郎 👱🏻‍♀
金发女子	金发女子 👱🏻‍♀
金髮	金髮 👱 👱🏻‍♀ 👱🏻‍♂ 👱🏼
金髮的人	金髮的人 👱
金髮男子	金髮男子 👱 👱🏻‍♂
金髮女郎	金髮女郎 👱🏻‍♀
金髮女子	金髮女子 👱🏻‍♀
金牛座	金牛座 ♉ ♉️
金牌	金牌 🥇
金钱	金钱 💰 💲 💳 💴 💵 💶 💷 💸
金錢	金錢 💰 💲 💳 💴 💵 💶 💷 💸
金钥	金钥 🔑
金鑰	金鑰 🔑
津巴布韦	津巴布韦 🇿🇼
津巴布韋	津巴布韋 🇿🇼
紧急	紧急 🆘 🆘️
紧张	紧张 💗 😓
谨言	谨言 🙊
緊急	緊急 🆘 🆘️
緊張	緊張 💗 😓
謹言	謹言 🙊
进城务工人员	进城务工人员 👷 👷🏻‍♀ 👷🏻‍♂ 👷🏻
近视	近视 👓
近视眼镜	近视眼镜 👓
近視	近視 👓
近視眼鏡	近視眼鏡 👓
進城務工人員	進城務工人員 👷 👷🏻‍♀ 👷🏻‍♂ 👷🏻
禁	禁 🈲 🈲️
禁打电话	禁打电话 📵
禁打電話	禁打電話 📵
禁丟垃圾	禁丟垃圾 🚯
禁丢垃圾	禁丢垃圾 🚯
禁行	禁行 ⛔ 🚷 🚷
禁行单车	禁行单车 🚳
禁行單車	禁行單車 🚳
禁声	禁声 🔇
禁聲	禁聲 🔇
禁烟	禁烟 🚭
禁菸	禁菸 🚭
禁煙	禁煙 🚭
禁用手机	禁用手机 📵
禁用手機	禁用手機 📵
禁止	禁止 ⛔ 🚫 🚳 📵 🚭 🚯 🚱 🚷 🔞 ✋ ❌ 🈲 ✋🏻 🛑 ⛔️ ✋🏻 🛑
禁止单车	禁止单车 🚳
禁止單車	禁止單車 🚳
禁止丢垃圾	禁止丢垃圾 🚯
禁止行人	禁止行人 🚷
禁止进入	禁止进入 ⛔
禁止進入	禁止進入 ⛔
禁止骑车	禁止骑车 🚳
禁止骑行	禁止骑行 🚳
禁止騎車	禁止騎車 🚳
禁止騎行	禁止騎行 🚳
禁止扔垃圾	禁止扔垃圾 🚯
禁止通行	禁止通行 ⛔
禁止通话	禁止通话 📵
禁止通話	禁止通話 📵
禁止吸烟	禁止吸烟 🚭
禁止吸煙	禁止吸煙 🚭
禁止饮水	禁止饮水 🚱
禁止饮用	禁止饮用 🚱
禁止飲水	禁止飲水 🚱
禁止飲用	禁止飲用 🚱
惊	惊 😨 😱
惊悚	惊悚 😱 🙀
惊叹	惊叹 ❕ ❗ 😮 😲 ‼ ⁉ ‽
惊叹号	惊叹号 ❕ ❗
惊叹号加问号	惊叹号加问号 ⁉
惊问	惊问 ⁉
惊喜	惊喜 😃 🤩
惊吓	惊吓 🙀
惊讶	惊讶 😮 😲 ‼ ⁉ ❕ ❗ ‽ 😺 🙀
惊讶怀疑	惊讶怀疑 ⁉
惊艳	惊艳 🤩
精怪	精怪 🧙🏻 🧝🏻 🧛🏻 🧟 🧞 🧜🏻 🧚🏻 🦹🏻‍♂ 🧙🏻 🧝🏻 🧛🏻 🧟 🧞 🧜🏻 🧚🏻 🦹🏻
精灵	精灵 🧝‍♂ 🧝 🧝‍♀ 🧝🏻‍♂ 🧝🏼‍♂ 🧝🏽‍♂ 🧝🏾‍♂ 🧝🏿‍♂ 🧝🏻 🧝🏼 🧝🏽 🧝🏾 🧝🏿 🧝🏻‍♀ 🧝🏼‍♀ 🧝🏽‍♀ 🧝🏾‍♀ 🧝🏿‍♀ 🧝🏻
精灵族	精灵族 🧝🏻‍♀ 🧝🏻‍♂ 🧝🏻
精靈	精靈 🧝🏻‍♀ 🧝🏻‍♂ 🧝🏻
精靈族	精靈族 🧝🏻‍♀ 🧝🏻‍♂ 🧝🏻
鲸	鲸 🐳 🐋 🐋
鲸鱼	鲸鱼 🐳 🐋 🐋
鲸鱼喷水	鲸鱼喷水 🐳
鲸鱼座	鲸鱼座 🔯
鯨	鯨 🐋 🐳 🐋
鯨魚	鯨魚 🐋 🐳 🐋
鯨魚噴水	鯨魚噴水 🐳
鯨魚座	鯨魚座 🔯
驚悚	驚悚 😱 🙀
驚嘆	驚嘆 ‼ ❕ ❗
驚嘆號	驚嘆號 ❕ ❗
驚嘆號加問號	驚嘆號加問號 ⁉
驚問	驚問 ⁉
驚喜	驚喜 😃 🤩
驚嚇	驚嚇 🙀
驚訝	驚訝 ‼ ❕ ❗ 😺 🙀
驚訝懷疑	驚訝懷疑 ⁉
驚艷	驚艷 🤩
井	井 #
井号键	井号键 #⃣ #️⃣
井號鍵	井號鍵 #⃣ #️⃣
景点	景点 🗽 🏰 🗼 🗻 🏯 🏝 🏖 🌁 🌉 🏞
景點	景點 🗽 🏰 🗼 🗻 🏯 🏝 🏖 🌁 🌉 🏞
警察	警察 👮 👮‍♂ 👮‍♀ 👮🏻‍♂ 👮🏼‍♂ 👮🏽‍♂ 👮🏾‍♂ 👮🏿‍♂ 👮🏻 👮🏼 👮🏽 👮🏾 👮🏿 👮🏻‍♀ 👮🏼‍♀ 👮🏽‍♀ 👮🏾‍♀ 👮🏿‍♀ 🚔 👮🏻
警车	警车 🚓 🚔 🚨 🚓
警车灯	警车灯 🚨
警車	警車 🚓 🚔 🚓
警車燈	警車燈 🚨
警灯	警灯 🚨
警燈	警燈 🚨
警告	警告 ⚠ 🛑 ⚠️ 🛑
警示	警示 ⚠
警示灯	警示灯 🚨
警示燈	警示燈 🚨
警卫	警卫 💂‍♂ 💂 💂‍♀ 💂🏻‍♂ 💂🏼‍♂ 💂🏽‍♂ 💂🏾‍♂ 💂🏿‍♂ 💂🏻 💂🏼 💂🏽 💂🏾 💂🏿 💂🏻‍♀ 💂🏼‍♀ 💂🏽‍♀ 💂🏾‍♀ 💂🏿‍♀
胫	胫 🦵🏻
竞技场	竞技场 🏟 🏟️
脛	脛 🦵🏻
静音	静音 🔇
静坐	静坐 🧘🏻‍♀ 🧘🏻‍♂ 🧘🏻
靜音	靜音 🔇
靜坐	靜坐 🧘🏻‍♀ 🧘🏻‍♂ 🧘🏻
競技場	競技場 🏟 🏟️
囧	囧 😅 😰 😳 😅 😰
窘	窘 😅
纠结	纠结 😂 🤦🏻‍♀ 🤦🏻‍♂ 😂 🤦🏻
糾結	糾結 😂 🤦🏻‍♀ 🤦🏻‍♂ 😂 🤦🏻
九	九 九、 玖 Ⅸ 〩 ⁹ ₉ ⓽ 𝟡 ⒐ 🄊 ㊈ ㈨ 9⃣ 𓃑 9️⃣
九点	九点 🕘
九点半	九点半 🕤
九点钟	九点钟 🕘
九點	九點 🕘
九點半	九點半 🕤
九點鐘	九點鐘 🕘
九枝灯台	九枝灯台 🕎
九枝燈臺	九枝燈臺 🕎
酒	酒 🍷 🍸 🍹 🍺 🍻 🥂 🥃 🥤 🍶 🍾 🍷 🥃 🍺 🍶 🍾 🍸
酒杯	酒杯 🍷 🍸 🥃
酒店	酒店 🏨
酒馆	酒馆 🏮
酒館	酒館 🏮
酒瓶和酒杯	酒瓶和酒杯 🍶
酒水	酒水 🍶
酒盏	酒盏 🥃
酒盞	酒盞 🥃
旧房子	旧房子 🏚 🏚️
旧屋	旧屋 🏚 🏚️
救护车	救护车 🚑
救護車	救護車 🚑
救火	救火 🚒
救火车	救火车 🚒
救火車	救火車 🚒
救火队	救火队 👨🏻‍🚒 👩🏻‍🚒 🧑🏻‍🚒
救火隊	救火隊 👨🏻‍🚒 👩🏻‍🚒 🧑🏻‍🚒
救命	救命 🆘 🆘️
救生	救生 🦺
就那样	就那样 😌 😏 😼
就那樣	就那樣 😌 😏 😼
舊房子	舊房子 🏚 🏚️
舊屋	舊屋 🏚 🏚️
居酒屋	居酒屋 🏮
居酒屋灯笼	居酒屋灯笼 🏮
居酒屋燈籠	居酒屋燈籠 🏮
掬	掬 🤲🏻
鞠躬	鞠躬 🙇‍♂ 🙇‍ 🙇‍♀ 🙇🏻‍♂ 🙇🏼‍♂ 🙇🏽‍♂ 🙇🏾‍♂ 🙇🏿‍♂ 🙇🏻 🙇🏼 🙇🏽 🙇🏾 🙇🏿 🙇🏻‍♀ 🙇🏼‍♀ 🙇🏽‍♀ 🙇🏾‍♀ 🙇🏿‍♀ 🙇 🙇🏻
桔子	桔子 🍊
菊	菊 🀥 🌼 🌼
菊花	菊花 🌼
焗饭	焗饭 🥘
焗飯	焗飯 🥘
橘色书本	橘色书本 📙
橘色書本	橘色書本 📙
橘心	橘心 🧡
橘子	橘子 🍊
沮喪	沮喪 🙍 🙍🏻‍♀ 🙍🏻‍♂ 🙍🏻
沮丧	沮丧 🙍 🙍🏻‍♀ 🙍🏻‍♂ 🙍🏻
举起拳头	举起拳头 ✊ ✊🏻 ✊🏻
举手	举手 🙋‍♂ 🙋 🙋‍♀ ✋ 🙌 🙋🏻‍♂ 🙋🏼‍♂ 🙋🏽‍♂ 🙋🏾‍♂ 🙋🏿‍♂ 🙋🏻 🙋🏼 🙋🏽 🙋🏾 🙋🏿 🙋🏻‍♀ 🙋🏼‍♀ 🙋🏽‍♀ 🙋🏾‍♀ 🙋🏿‍♀ ✋🏻 ✋🏼 ✋🏽 ✋🏾 ✋🏿 🙌🏻 🙌🏼 🙌🏽 🙌🏾 🙌🏿
举重	举重 🏋‍♂ 🏋 🏋‍♀ 🏋🏻‍♂ 🏋🏼‍♂ 🏋🏽‍♂ 🏋🏾‍♂ 🏋🏿‍♂ 🏋🏻 🏋🏼 🏋🏽 🏋🏾 🏋🏿 🏋🏻‍♀ 🏋🏼‍♀ 🏋🏽‍♀ 🏋🏾‍♀ 🏋🏿‍♀ 🏋🏻
舉起拳頭	舉起拳頭 ✊ ✊🏻 ✊🏻
舉手	舉手 🙋
舉重	舉重 🏋 🏋🏻‍♀ 🏋🏻‍♂ 🏋🏻
巨石像	巨石像 🗿
巨蟹座	巨蟹座 ♋ ♋️
句号	句号 。 .
拒绝	拒绝 ❌
拒絕	拒絕 ❌
拒马	拒马 🚧
拒馬	拒馬 🚧
距离	距离 ㎙ ㎚ ㎛ ㎜ ㎝ ㎞
聚会	聚会 🥳 🎉 🎊 🍻 🍻
聚會	聚會 🍻
卷	卷 🥙 🌮 🌯 🥙 🌮 🌯 🫔
卷饼	卷饼 🌯
卷动	卷动 📜
卷发	卷发 👨‍🦱 👩‍🦱 👨🏻‍🦱 👨🏼‍🦱 👨🏽‍🦱 👨🏾‍🦱 👨🏿‍🦱 👩🏻‍🦱 👩🏼‍🦱 👩🏽‍🦱 👩🏾‍🦱 👩🏿‍🦱 🧑🏻‍🦱
卷毛狗	卷毛狗 🐩
卷虾	卷虾 🍤
卷纸	卷纸 🧻
卷轴	卷轴 📜
卷軸	卷軸 📜
卷宗	卷宗 📜
捲	捲 🥙 🌮 🌯 🥙 🌮 🌯 🫔
捲餅	捲餅 🌯
捲動	捲動 📜
捲髮	捲髮 👨🏻‍🦱 👩🏻‍🦱 🧑🏻‍🦱
捲毛狗	捲毛狗 🐩
捲蝦	捲蝦 🍤
捲紙	捲紙 🧻
撅嘴	撅嘴 😗
噘嘴	噘嘴 😗 😠 😡 😾 🙎 🙎🏻‍♀ 🙎🏻‍♂ 😗 🙎🏻
军功章	军功章 🎖
菌	菌 🍄
菌类	菌类 🍄
菌類	菌類 🍄
咖啡	咖啡 ☕ ☕️
咖喱	咖喱 🍛
咖喱饭	咖喱饭 🍛
咖喱飯	咖喱飯 🍛
咖哩饭	咖哩饭 🍛
咖哩飯	咖哩飯 🍛
喀麦隆	喀麦隆 🇨🇲
喀麥隆	喀麥隆 🇨🇲
卡车	卡车 🚛 🚛 🛻
卡車	卡車 🚛 🚛 🛻
卡达	卡达 🇶🇦
卡達	卡達 🇶🇦
卡路里	卡路里 ㎈ ㎉ ㌍
卡片索引	卡片索引 📇
卡士达	卡士达 🍮
卡士達	卡士達 🍮
卡塔尔	卡塔尔 🇶🇦
卡塔爾	卡塔爾 🇶🇦
开车	开车 🚘
开饭	开饭 😋
开花	开花 🌼
开怀大笑	开怀大笑 😃
开曼	开曼 🇰🇾
开曼群岛	开曼群岛 🇰🇾
开启	开启 🔛
开启资料夹	开启资料夹 📂
开始录像	开始录像 ⏺ ⏺️
开始录音	开始录音 ⏺ ⏺️
开锁	开锁 🔓
开玩笑	开玩笑 😜 😝 😜
开心	开心 😀 😁 😂 🤣 😃 😄 😅 😆 😉 😊 😋 😎 😺 😸 😹 ☺ 🥳 😁 🥳
開車	開車 🚘
開飯	開飯 😋
開花	開花 🌼
開懷大笑	開懷大笑 😃
開曼	開曼 🇰🇾
開曼群島	開曼群島 🇰🇾
開啟資料夾	開啟資料夾 📂
開啓	開啓 🔛
開始錄像	開始錄像 ⏺ ⏺️
開始錄音	開始錄音 ⏺ ⏺️
開鎖	開鎖 🔓
開玩笑	開玩笑 😜 😝 😜
開心	開心 ☺ 😁 😃 😄 😆 😺 🥳 😁 🥳
坎	坎 ☵
看	看 👀
看不懂	看不懂 😵 😵 😵‍💫
看不见	看不见 🙈
看不見	看不見 🙈
看电影	看电影 🎦
看電影	看電影 🎦
看守	看守 💂 💂🏻‍♀ 💂🏻‍♂ 💂🏻
看书	看书 📖 🤓
看書	看書 📖 🤓
考拉	考拉 🐨
考虑	考虑 💭
考慮	考慮 💭
烤薄饼	烤薄饼 🍕
烤薄餅	烤薄餅 🍕
烤饼	烤饼 🥞 🥞 🫓
烤餅	烤餅 🥞 🥞 🫓
烤地瓜	烤地瓜 🍠
烤红薯	烤红薯 🍠
烤紅薯	烤紅薯 🍠
烤鸡腿	烤鸡腿 🍖
烤雞腿	烤雞腿 🍖
靠	靠 😧
科科斯	科科斯 🇨🇨
科摩罗	科摩罗 🇰🇲
科摩羅	科摩羅 🇰🇲
科索沃	科索沃 🇽🇰
科特迪瓦	科特迪瓦 🇨🇮
科威科	科威科 🇰🇼
科威特	科威特 🇰🇼
科学	科学 🔬 🔭 ⚗ ⚛ 👨🏻‍🔬 👩🏻‍🔬 🧬 🧪 🧫 🔬 🔭 ⚗️ ⚛️ 🧑🏻‍🔬 🧬 🧪 🧫 🩺 🩻
科学家	科学家 👨‍🔬 🧑‍🔬 👩‍🔬 👨🏻‍🔬 👨🏼‍🔬 👨🏽‍🔬 👨🏾‍🔬 👨🏿‍🔬 🧑🏻‍🔬 🧑🏼‍🔬 🧑🏽‍🔬 🧑🏾‍🔬 🧑🏿‍🔬 👩🏻‍🔬 👩🏼‍🔬 👩🏽‍🔬 👩🏾‍🔬 👩🏿‍🔬 🧑🏻‍🔬
科學	科學 🔬 🔭 ⚗ ⚛ 👨🏻‍🔬 👩🏻‍🔬 🧬 🧪 🧫 🔬 🔭 ⚗️ ⚛️ 🧑🏻‍🔬 🧬 🧪 🧫 🩺 🩻
科學家	科學家 👨🏻‍🔬 👩🏻‍🔬 🧑🏻‍🔬
科研人员	科研人员 👨🏻‍🔬 👩🏻‍🔬 🧑🏻‍🔬
科研人員	科研人員 👨🏻‍🔬 👩🏻‍🔬 🧑🏻‍🔬
磕头	磕头 🙇 🙇🏻‍♀ 🙇🏻‍♂ 🙇🏻
磕頭	磕頭 🙇 🙇🏻‍♀ 🙇🏻‍♂ 🙇🏻
蝌蚪	蝌蚪 𓆐
可	可 🉑 🉑️
可爱	可爱 😊 🐶 💠 🥰 💠 🥰
可愛	可愛 🐶 💠 😊 🥰 💠 🥰
可回收	可回收 ♻ ♻️
可拉熊	可拉熊 🐨
可乐	可乐 🥤
可怜	可怜 🥺
可憐	可憐 🥺
可怕	可怕 😨 😱 🙀 🤯
可以	可以 🙆‍♂ 🙆 🙆‍♀ 👌 👍 🆗 🙆🏻‍♂ 🙆🏼‍♂ 🙆🏽‍♂ 🙆🏾‍♂ 🙆🏿‍♂ 🙆🏻 🙆🏼 🙆🏽 🙆🏾 🙆🏿 🙆🏻‍♀ 🙆🏼‍♀ 🙆🏽‍♀ 🙆🏾‍♀ 🙆🏿‍♀ 👌🏻 👌🏼 👌🏽 👌🏾 👌🏿 👍🏻 👍🏼 👍🏽 👍🏾 👍🏿 😉 🆗️ 👌🏻 😉
可樂	可樂 🥤
可真	可真 😓
渴望	渴望 😻
克	克 ㎍ ㎎ ㎏ ㌘
克尔白	克尔白 🕋
克爾白	克爾白 🕋
克利珀顿	克利珀顿 🇨🇵
克罗埃西亚	克罗埃西亚 🇭🇷
克罗地亚	克罗地亚 🇭🇷
克羅埃西亞	克羅埃西亞 🇭🇷
克羅地亞	克羅地亞 🇭🇷
客轮	客轮 🛳 🛳️
客輪	客輪 🛳 🛳️
客气	客气 😎
客氣	客氣 😎
客人帐户	客人帐户 👤
客人帳戶	客人帳戶 👤
课本	课本 📖
课室	课室 👨🏻‍🏫 👩🏻‍🏫 🧑🏻‍🏫
课堂	课堂 👨🏻‍🏫 👩🏻‍🏫 🧑🏻‍🏫
課本	課本 📖
課室	課室 👨🏻‍🏫 👩🏻‍🏫 🧑🏻‍🏫
課堂	課堂 👨🏻‍🏫 👩🏻‍🏫 🧑🏻‍🏫
肯定	肯定 🙆
肯尼亚	肯尼亚 🇰🇪
肯尼亞	肯尼亞 🇰🇪
肯亚	肯亚 🇰🇪
肯亞	肯亞 🇰🇪
恳请	恳请 🥺
恳求	恳求 🥺 🙇 🙏 🥺
懇請	懇請 🥺
懇求	懇求 🙇 🙏 🥺 🥺
空	空 ∅ 🈳 🈳️
空集	空集 ∅
空气不好	空气不好 🌁
空气差	空气差 😷
空气污染	空气污染 🏭
空氣不好	空氣不好 🌁
空氣差	空氣差 😷
空氣污染	空氣污染 🏭
空手道	空手道 🥋
空碗	空碗 🥣
空位	空位 🈳
孔雀	孔雀 🦚
孔雀之国	孔雀之国 🇮🇳
孔雀之國	孔雀之國 🇮🇳
恐怖	恐怖 😱 🙀
恐惧	恐惧 😱
恐懼	恐懼 😱
恐龙	恐龙 🦖 🦕 🦕 🦖
恐龍	恐龍 🦕 🦖
口	口 👄
口岸	口岸 🛂
口红	口红 💄
口紅	口紅 💄
口水	口水 🤤
口罩	口罩 😷
扣在一起	扣在一起 🖇 🖇️
枯萎	枯萎 🥀
枯叶	枯叶 🍂
枯葉	枯葉 🍂
哭	哭 😢 😭 😿 😭
哭了	哭了 😭
哭泣	哭泣 😢 😭 😿 😭
哭笑	哭笑 😂 😹
骷髅	骷髅 💀 ☠ 💀
骷髅头	骷髅头 💀
骷髏	骷髏 💀
骷髏頭	骷髏頭 💀
苦恼	苦恼 😖
苦惱	苦惱 😖
苦笑	苦笑 😁 😼
库克群岛	库克群岛 🇨🇰
库拉索	库拉索 🇨🇼
庫克群島	庫克群島 🇨🇰
庫拉索	庫拉索 🇨🇼
裤	裤 👖
裤子	裤子 👖
酷	酷 😎 🆒 🆒️ 😎
酷炫	酷炫 😎
酷炫狂跩	酷炫狂跩 😎
褲	褲 👖
褲子	褲子 👖
挎包	挎包 👜
快餐	快餐 🍔 🌭 🍟 🥞 🥡 🥫 🍱
快餐盒	快餐盒 🥡
快递	快递 📦 🚚
快递盒	快递盒 📦
快遞	快遞 📦 🚚
快遞盒	快遞盒 📦
快件	快件 📦
快进	快进 ⏩ 🔜
快進	快進 ⏩ 🔜
快乐	快乐 😀 😁 😂 🤣 😃 😄 😅 😆 😉 😊 😋 😎 😺 😸 😹
快跑	快跑 💨
快速	快速 🔜
快艇	快艇 🚤 🛥 🛥️
快退	快退 ⏪
筷	筷 🥢
筷子	筷子 🥢
宽度	宽度 ↔ ↔️
寬度	寬度 ↔ ↔️
狂笑	狂笑 🤣
亏损	亏损 💸
亏损报表	亏损报表 📉
亏凸月	亏凸月 🌖
虧損	虧損 💸
虧損報表	虧損報表 📉
虧凸月	虧凸月 🌖
坤	坤 ☷
困	困 😪 😴 🥱 😞 😞 😴
困惑	困惑 😕 😖 🥴 🤔 🤨 ❓ ❔
困觉	困觉 😴
困倦	困倦 😪 🙀
困了	困了 😴
睏	睏 😪 😴 🥱 😞 😞 😴
睏覺	睏覺 😴
睏了	睏了 😴
扩音喇叭	扩音喇叭 📢
扩音器	扩音器 📢 📣 📣
括号	括号 [] 〈〉 《》 ⁽⁾ ₍₎ 「」 『』 【】 〔〕 ︵ ︶ ︷ ︸ ︹ ︺ ︻ ︼ ︽ ︾ ︿ ﹀ ﹁ ﹂ ﹃ ﹄ ﹙﹚ ﹛﹜ ﹝﹞ ﹤﹥ （） ＜＞ ｛｝
擴音喇叭	擴音喇叭 📢
擴音器	擴音器 📢 📣 📣
垃圾	垃圾 🙃 🚮 🚯 👎 👎🏻
垃圾入篓	垃圾入篓 🚮
垃圾入簍	垃圾入簍 🚮
垃圾桶	垃圾桶 🗑 🚮 🚯
垃圾筒	垃圾筒 🗑 🗑️
拉丁裔	拉丁裔 👨🏽 👩🏽 👴🏽 👵🏽 👦🏽 👧🏽 👶🏽 🧓🏽 🧑🏽 🧒🏽
拉弓	拉弓 🏹
拉拉	拉拉 👭 👭🏻
拉美裔	拉美裔 👨🏽 👩🏽 👴🏽 👵🏽 👦🏽 👧🏽 👶🏽 🧓🏽 🧑🏽 🧒🏽
拉面	拉面 🍜
拉麵	拉麵 🍜
拉炮	拉炮 🎉
拉普拉斯	拉普拉斯 ∇² ∇·∇
拉普拉斯算符	拉普拉斯算符 ∇² ∇·∇
拉屎	拉屎 💩
拉手	拉手 👬 👫 👭 👬🏻 👨🏻‍🤝‍👨🏼 👨🏻‍🤝‍👨🏽 👨🏻‍🤝‍👨🏾 👨🏻‍🤝‍👨🏿 👨🏼‍🤝‍👨🏻 👬🏼 👨🏼‍🤝‍👨🏽 👨🏼‍🤝‍👨🏾 👨🏼‍🤝‍👨🏿 👨🏽‍🤝‍👨🏻 👨🏽‍🤝‍👨🏼 👬🏽 👨🏽‍🤝‍👨🏾 👨🏽‍🤝‍👨🏿 👨🏾‍🤝‍👨🏻 👨🏾‍🤝‍👨🏼 👨🏾‍🤝‍👨🏽 👬🏾 👨🏾‍🤝‍👨🏿 👨🏿‍🤝‍👨🏻 👨🏿‍🤝‍👨🏼 👨🏿‍🤝‍👨🏽 👨🏿‍🤝‍👨🏾 👬🏿 👫🏻 👩🏻‍🤝‍👨🏼 👩🏻‍🤝‍👨🏽 👩🏻‍🤝‍👨🏾 👩🏻‍🤝‍👨🏿 👩🏼‍🤝‍👨🏻 👫🏼 👩🏼‍🤝‍👨🏽 👩🏼‍🤝‍👨🏾 👩🏼‍🤝‍👨🏿 👩🏽‍🤝‍👨🏻 👩🏽‍🤝‍👨🏼 👫🏽 👩🏽‍🤝‍👨🏾 👩🏽‍🤝‍👨🏿 👩🏾‍🤝‍👨🏻 👩🏾‍🤝‍👨🏼 👩🏾‍🤝‍👨🏽 👫🏾 👩🏾‍🤝‍👨🏿 👩🏿‍🤝‍👨🏻 👩🏿‍🤝‍👨🏼 👩🏿‍🤝‍👨🏽 👩🏿‍🤝‍👨🏾 👫🏿 👭🏻 👩🏻‍🤝‍👩🏼 👩🏻‍🤝‍👩🏽 👩🏻‍🤝‍👩🏾 👩🏻‍🤝‍👩🏿 👩🏼‍🤝‍👩🏻 👭🏼 👩🏼‍🤝‍👩🏽 👩🏼‍🤝‍👩🏾 👩🏼‍🤝‍👩🏿 👩🏽‍🤝‍👩🏻 👩🏽‍🤝‍👩🏼 👭🏽 👩🏽‍🤝‍👩🏾 👩🏽‍🤝‍👩🏿 👩🏾‍🤝‍👩🏻 👩🏾‍🤝‍👩🏼 👩🏾‍🤝‍👩🏽 👭🏾 👩🏾‍🤝‍👩🏿 👩🏿‍🤝‍👩🏻 👩🏿‍🤝‍👩🏼 👩🏿‍🤝‍👩🏽 👩🏿‍🤝‍👩🏾 👭🏿
拉脫維亞	拉脫維亞 🇱🇻
拉脱维亚	拉脱维亚 🇱🇻
拉脱維亞	拉脱維亞 🇱🇻
啦啦队	啦啦队 👯 📣 👯‍♂ 🥳 👯🏻 🥳
啦啦隊	啦啦隊 👯 📣 👯‍♂ 🥳 👯🏻 🥳
喇叭	喇叭 🎺 📯 📢 📣 🎺 📣
蜡笔	蜡笔 🖍 🖍️
蜡烛	蜡烛 🕯 🕯️
辣	辣 🌶 🌶️
辣椒	辣椒 🌶 🌶️
蠟筆	蠟筆 🖍 🖍️
蠟燭	蠟燭 🕯 🕯️
来电	来电 📲
来信	来信 📨
来邮件	来邮件 📨
來信	來信 📨
來郵件	來郵件 📨
莱索托	莱索托 🇱🇸
萊索托	萊索托 🇱🇸
赖比瑞亚	赖比瑞亚 🇱🇷
赖索托	赖索托 🇱🇸
賴比瑞亞	賴比瑞亞 🇱🇷
賴索托	賴索托 🇱🇸
兰	兰 🀣
蓝菱	蓝菱 🔷
蓝色书本	蓝色书本 📘
蓝色小菱形	蓝色小菱形 🔹
蓝色心形	蓝色心形 💙
蓝心	蓝心 💙
蓝眼睛	蓝眼睛 🧿
蓝藻	蓝藻 🦠
蓝珠	蓝珠 🔵
蓝子	蓝子 🔵
篮	篮 🧺
篮球	篮球 🏀 ⛹‍♂ ⛹ ⛹‍♀ ⛹🏻‍♂ ⛹🏼‍♂ ⛹🏽‍♂ ⛹🏾‍♂ ⛹🏿‍♂ ⛹🏻 ⛹🏼 ⛹🏽 ⛹🏾 ⛹🏿 ⛹🏻‍♀ ⛹🏼‍♀ ⛹🏽‍♀ ⛹🏾‍♀ ⛹🏿‍♀ 🏀
篮子	篮子 🧺
藍菱	藍菱 🔷
藍色書本	藍色書本 📘
藍色小菱形	藍色小菱形 🔹
藍色心形	藍色心形 💙
藍心	藍心 💙
藍眼睛	藍眼睛 🧿
藍藻	藍藻 🦠
藍珠	藍珠 🔵
藍子	藍子 🔵
籃	籃 🧺
籃球	籃球 🏀
缆车	缆车 🚡 🚠 🚡
纜車	纜車 🚠 🚡 🚡
烂	烂 👎 👎🏻 👎🏻
烂房子	烂房子 🏚 🏚️
烂玩意	烂玩意 😒
烂玩意儿	烂玩意儿 😒
爛	爛 👎 👎🏻 👎🏻
爛房子	爛房子 🏚 🏚️
爛玩意	爛玩意 😒
爛玩意兒	爛玩意兒 😒
狼	狼 🐺
狼狗	狼狗 🐺
狼脸	狼脸 🐺
狼臉	狼臉 🐺
浪	浪 🌊
浪漫	浪漫 🌹 💋 💌 💍 💎 💏 💐 💑 💒 💓 💔 💕 💖 💗 💘 💙 💚 💛 💜 💝 💞 💟
劳	劳 ㊘ ㈸
劳动	劳动 ⚒ ⚒️
劳工	劳工 👨🏻‍🏭 👩🏻‍🏭 👨🏻‍🏭 🧑🏻‍🏭
劳作	劳作 ⚒ ⚒️
勞動	勞動 ⚒ ⚒️
勞工	勞工 👨🏻‍🏭 👩🏻‍🏭 👨🏻‍🏭 🧑🏻‍🏭
勞作	勞作 ⚒ ⚒️
老	老 👴 👵 🧓🏻 🧓🏻
老爸	老爸 👨 👨🏻 👨🏻
老豆	老豆 👨 👨🏻 👨🏻
老窦	老窦 👨 👨🏻 👨🏻
老竇	老竇 👨 👨🏻 👨🏻
老妇人	老妇人 👵
老婦人	老婦人 👵
老倌	老倌 👴 👴🏻 👴🏻
老虎	老虎 🐯 🐅 🐅
老虎机	老虎机 🎰
老虎機	老虎機 🎰
老虎脸	老虎脸 🐯
老虎臉	老虎臉 🐯
老火车	老火车 🚂
老火車	老火車 🚂
老妈	老妈 👩 👩🏻 👩🏻
老媽	老媽 👩 👩🏻 👩🏻
老母	老母 👩 👩🏻 👩🏻
老奶	老奶 👵 👵🏻 👵🏻
老奶奶	老奶奶 👵
老男人	老男人 👴 👴🏻 👴🏻
老年人	老年人 👴 👨‍🦳 👵 🧓 👴🏻 👴🏼 👴🏽 👴🏾 👴🏿 👨🏻‍🦳 👨🏼‍🦳 👨🏽‍🦳 👨🏾‍🦳 👨🏿‍🦳 👵🏻 👵🏼 👵🏽 👵🏾 👵🏿 🧓🏻 🧓🏼 🧓🏽 🧓🏾 🧓🏿
老女人	老女人 👵 👵🏻 👵🏻
老人	老人 👴 👨‍🦳 👵 🧓 👴🏻 👴🏼 👴🏽 👴🏾 👴🏿 👨🏻‍🦳 👨🏼‍🦳 👨🏽‍🦳 👨🏾‍🦳 👨🏿‍🦳 👵🏻 👵🏼 👵🏽 👵🏾 👵🏿 🧓🏻 🧓🏼 🧓🏽 🧓🏾 🧓🏿 🧓🏻
老师	老师 👨‍🏫 🧑‍🏫 👩‍🏫 👨🏻‍🏫 👨🏼‍🏫 👨🏽‍🏫 👨🏾‍🏫 👨🏿‍🏫 🧑🏻‍🏫 🧑🏼‍🏫 🧑🏽‍🏫 🧑🏾‍🏫 🧑🏿‍🏫 👩🏻‍🏫 👩🏼‍🏫 👩🏽‍🏫 👩🏾‍🏫 👩🏿‍🏫 🧑🏻‍🏫
老師	老師 👨🏻‍🏫 👩🏻‍🏫 🧑🏻‍🏫
老鼠	老鼠 🐭 🐁 🐀 🐀
老鼠脸	老鼠脸 🐭
老鼠臉	老鼠臉 🐭
老太	老太 👵 👵🏻 👵🏻
老太太	老太太 👵 🧓 👵🏻 👵🏼 👵🏽 👵🏾 👵🏿 🧓🏻 🧓🏼 🧓🏽 🧓🏾 🧓🏿
老头	老头 👴 👨‍🦳 👴🏻 👴🏼 👴🏽 👴🏾 👴🏿 👨🏻‍🦳 👨🏼‍🦳 👨🏽‍🦳 👨🏾‍🦳 👨🏿‍🦳 👴🏻
老頭	老頭 👴 👴🏻 👴🏻
老挝	老挝 🇱🇦
老撾	老撾 🇱🇦
老爷爷	老爷爷 👴
老爺爺	老爺爺 👴
老鹰	老鹰 🦅 𓄿 𓆂 🦅
老鷹	老鷹 🦅
老遊戲	老遊戲 👾
老游戏	老游戏 👾
老者	老者 👴 👨‍🦳 👵 🧓 👴🏻 👴🏼 👴🏽 👴🏾 👴🏿 👨🏻‍🦳 👨🏼‍🦳 👨🏽‍🦳 👨🏾‍🦳 👨🏿‍🦳 👵🏻 👵🏼 👵🏽 👵🏾 👵🏿 🧓🏻 🧓🏼 🧓🏽 🧓🏾 🧓🏿
姥姥	姥姥 👵 👵🏻 👵🏻
姥爷	姥爷 👴 👴🏻 👴🏻
姥爺	姥爺 👴 👴🏻 👴🏻
叻女	叻女 🤩
叻仔	叻仔 😇 🤩 🤩
乐谱	乐谱 🎼
乐器	乐器 🎻 🎸 🎹 🎷 🎺 🥁 🎻 🎸 🎹 🎷 🎺 🥁 🪕 🪘 🪗
乐曲	乐曲 🎼
雷	雷 🌩 🌩️
雷达	雷达 📡
雷達	雷達 📡
雷锋叔叔	雷锋叔叔 👲
雷鋒叔叔	雷鋒叔叔 👲
雷雨	雷雨 ⛈ ⛈️
雷阵雨	雷阵雨 ⛈ ⛈️
雷陣雨	雷陣雨 ⛈ ⛈️
垒球	垒球 🥎
壘球	壘球 🥎
肋排	肋排 🥩
泪	泪 😭
泪流满面	泪流满面 😭
累	累 😫 😩 🙀
累了	累了 😑
淚	淚 😭
淚流滿面	淚流滿面 😭
冷	冷 🥶 ❄ ❄️ 🥶
冷汗	冷汗 😅 😓 😰
冷漠	冷漠 😶 😒 😶
冷笑	冷笑 😏
冷饮	冷饮 🍹
冷飲	冷飲 🍹
厘	厘 ㌢
厘米	厘米 ㎝
离	离 ☲
梨	梨 🍐
梨子	梨子 🍐
梨头	梨头 🍐
黎巴嫩	黎巴嫩 🇱🇧
礼拜室	礼拜室 🛐
礼拜堂	礼拜堂 ⛪
礼宾花	礼宾花 🎉
礼服	礼服 👗
礼盒	礼盒 🎁
礼花	礼花 🎆 🎇 🎆
礼帽	礼帽 🎩 👒 👒
礼品	礼品 🎁 📦 🎁
礼品盒	礼品盒 🎁
礼物	礼物 🎁 🎀 💝 🎁 💝
理发	理发 💇‍♂ 💇 💇‍♀ 💇🏻‍♂ 💇🏼‍♂ 💇🏽‍♂ 💇🏾‍♂ 💇🏿‍♂ 💇🏻 💇🏼 💇🏽 💇🏾 💇🏿 💇🏻‍♀ 💇🏼‍♀ 💇🏽‍♀ 💇🏾‍♀ 💇🏿‍♀ 💈 💇🏻
理发店	理发店 💈
理髮	理髮 💇 💈 💇🏻‍♀ 💇🏻‍♂ 💇🏻
理髮店	理髮店 💈
鲤鱼	鲤鱼 🎏
鲤鱼旗	鲤鱼旗 🎏
禮拜堂	禮拜堂 ⛪
禮賓花	禮賓花 🎉
禮服	禮服 👗
禮盒	禮盒 🎁
禮花	禮花 🎆
禮帽	禮帽 🎩 👒 👒
禮品	禮品 🎁 📦 🎁
禮品盒	禮品盒 🎁
禮物	禮物 🎁 💝
鯉魚旗	鯉魚旗 🎏
力量	力量 💪 🦾 💪🏻 💪🏼 💪🏽 💪🏾 💪🏿 💪🏻
厉害	厉害 😼 🤩 🤩
立方米	立方米 m³
立陶宛	立陶宛 🇱🇹
利比里亚	利比里亚 🇱🇷
利比里亞	利比里亞 🇱🇷
利比亚	利比亚 🇱🇾
利比亞	利比亞 🇱🇾
利是	利是 🧧
栗	栗 🌰
栗子	栗子 🌰
脷	脷 👅
厲害	厲害 😼 🤩 🤩
连接	连接 🔗
连结	连结 🔗
连衣裙	连衣裙 👗
莲花	莲花 ࿆ 🪷
莲蓬头	莲蓬头 🚿
連接	連接 🔗
連結	連結 🔗
連衣裙	連衣裙 👗
联合国	联合国 🇺🇳
联结	联结 🔗
蓮蓬頭	蓮蓬頭 🚿
聯合國	聯合國 🇺🇳
聯結	聯結 🔗
脸部器官	脸部器官 👂 👄
脸红	脸红 😳 ☺ 😊 ☺️ 😊
臉部器官	臉部器官 👂 👄
臉紅	臉紅 😳 ☺ 😊 ☺️ 😊
恋爱	恋爱 👫 👬 👭 💑 👨‍❤‍👨 👩‍❤‍👩 💑🏻
恋爱旅馆	恋爱旅馆 🏩
恋爱中	恋爱中 💑 💑🏻
恋人	恋人 💑
链接	链接 🔗
链条	链条 ⛓ ⛓️
链子	链子 🔗 ⛓
鏈接	鏈接 🔗
鏈條	鏈條 ⛓ ⛓️
戀愛	戀愛 💑 💑🏻
戀愛旅館	戀愛旅館 🏩
戀愛中	戀愛中 💑 💑🏻
戀人	戀人 💑
凉爽	凉爽 🆒
凉鞋	凉鞋 👡 👡 🩴
涼鞋	涼鞋 👡 👡 🩴
両替	両替 💱
两边打开	两边打开 🔛
两点	两点 🕑
两点半	两点半 🕝
两点钟	两点钟 🕑
两點半	两點半 🕝
两颗心	两颗心 💕
两人	两人 👥
两性	两性 ♂ ♀ ⚢ ⚣ ⚤ ⚥ ⚦ ⚧ ⚨ ⚩ ⚪ ⚫ ⚬ ⚭ ⚮ ⚯
两仪	两仪 ☯ ☯️
兩邊打開	兩邊打開 🔛
兩點	兩點 🕑
兩點半	兩點半 🕝
兩點鐘	兩點鐘 🕑
兩顆心	兩顆心 💕
兩人	兩人 👥
兩儀	兩儀 ☯ ☯️
亮蛋	亮蛋 👨🏻‍🦲 👩🏻‍🦲 🧑🏻‍🦲
亮度	亮度 🔅 🔆
亮晶晶	亮晶晶 ✨
靓女	靓女 👩 👩🏻 👩🏻
靓瞎	靓瞎 😍 😻
靓仔	靓仔 👨 👨🏻 👨🏻
靚女	靚女 👩 👩🏻 👩🏻
靚瞎	靚瞎 😍 😻
靚仔	靚仔 👨 👨🏻 👨🏻
聊天	聊天 💬
聊天气泡	聊天气泡 💬
聊天氣泡	聊天氣泡 💬
寮国	寮国 🇱🇦
寮國	寮國 🇱🇦
料	料 🈛
咧嘴	咧嘴 😁
列表循环	列表循环 🔄
列表循環	列表循環 🔄
列印机	列印机 🖨 🖨️
列印機	列印機 🖨 🖨️
列支敦士登	列支敦士登 🇱🇮
列支敦斯登	列支敦斯登 🇱🇮
淋浴	淋浴 🚿
〇	〇 0⃣ 0️⃣
灵魂	灵魂 👻
铃	铃 🛎 🔔 🔕 ⍾ 🛎️
铃当	铃当 🔔
铃铛	铃铛 🔔
菱形	菱形 🔶 🔷
零	零 〇 ⁰ ₀ 𝟘 🄀 🄁 ⓿ 0⃣ 0️⃣
零点	零点 🕛
零點	零點 🕛
零食	零食 🍭 🍬 🍫 🍿 🍩 🍪
鈴	鈴 🛎 🛎️
鈴噹	鈴噹 🔔
鈴鐺	鈴鐺 🔔
靈魂	靈魂 👻
领带	领带 👔
領帶	領帶 👔
溜冰	溜冰 ⛸ ⛸️
留尼汪	留尼汪 🇷🇪
留尼旺	留尼旺 🇷🇪
留尼旺島	留尼旺島 🇷🇪
流鼻涕	流鼻涕 🤧
流汗	流汗 😓 💦
流口水	流口水 🤤
流泪	流泪 😢 😭 😭
流淚	流淚 😢 😭 😭
流涎	流涎 🤤
流星	流星 🌠
流星雨	流星雨 🌠
六	六 六、 陆 Ⅵ 〦 ⁶ ₆ ⓺ 𝟞 ⒍ 🄇 ㊅ ㈥ 6⃣ 𓃎 6️⃣
六边形	六边形 ⎔
六点	六点 🕕
六点半	六点半 🕡
六点钟	六点钟 🕕
六點	六點 🕕
六點半	六點半 🕡
六點鐘	六點鐘 🕕
六角星	六角星 🔯
六芒星	六芒星 ✡ 🔯 ✡️
六十四卦	六十四卦 ䷀ ䷁ ䷂ ䷃ ䷄ ䷅ ䷆ ䷇ ䷈ ䷉ ䷊ ䷋ ䷌ ䷍ ䷎ ䷏ ䷐ ䷑ ䷒ ䷓ ䷔ ䷕ ䷖ ䷗ ䷘ ䷙ ䷚ ䷛ ䷜ ䷝ ䷞ ䷟ ䷠ ䷡ ䷢ ䷣ ䷤ ䷥ ䷦ ䷧ ䷨ ䷩ ䷪ ䷫ ䷬ ䷭ ䷮ ䷯ ䷰ ䷱ ䷲ ䷳ ䷴ ䷵ ䷶ ䷷ ䷸ ䷹ ䷺ ䷻ ䷼ ䷽ ䷾ ䷿ 乾䷀ 坤䷁ 屯䷂ 蒙䷃ 需䷄ 讼䷅ 师䷆ 比䷇ 小畜䷈ 履䷉ 泰䷊ 否䷋ 同人䷌ 大有䷍ 谦䷎ 豫䷏ 随䷐ 蛊䷑ 临䷒ 观䷓ 噬嗑䷔ 贲䷕ 剥䷖ 复䷗ 无妄䷘ 大畜䷙ 颐䷚ 大过䷛ 坎䷜ 离䷝ 咸䷞ 恒䷟ 遁䷠ 大壮䷡ 晋䷢ 明夷䷣ 家人䷤ 睽䷥ 蹇䷦ 解䷧ 损䷨ 益䷩ 夬䷪ 姤䷫ 萃䷬ 升䷭ 困䷮ 井䷯ 革䷰ 鼎䷱ 震䷲ 艮䷳ 渐䷴ 归妹䷵ 丰䷶ 旅䷷ 巽䷸ 兑䷹ 涣䷺ 节䷻ 中孚䷼ 小过䷽ 既济䷾ 未济䷿
六欲	六欲 眼（见欲，贪美色奇物） 耳（听欲，贪美音赞言） 鼻（香欲，贪香味） 舌（味欲，贪美食口快） 身（触欲，贪舒适享受） 意（意欲，贪声色、名利、恩爱） 色欲 形貌欲 威仪姿态欲 言语音声欲 细滑欲和人相欲
龙	龙 🐲 🐉 🐉
龙凤胎	龙凤胎 👨‍👩‍👧‍👦
龙卷风	龙卷风 🌪 🌀 🌪️
龙脸	龙脸 🐲
龙年	龙年 🐲
龙头	龙头 🐲
龙虾	龙虾 🦞
聋	聋 🧏‍♂ 🧏‍♀ 🧏 🦻 🧏🏻‍♂ 🧏🏼‍♂ 🧏🏽‍♂ 🧏🏾‍♂ 🧏🏿‍♂ 🧏🏻‍♀ 🧏🏼‍♀ 🧏🏽‍♀ 🧏🏾‍♀ 🧏🏿‍♀ 🧏🏻 🧏🏼 🧏🏽 🧏🏾 🧏🏿 🦻🏻 🦻🏼 🦻🏽 🦻🏾 🦻🏿 🧏🏻
聋哑	聋哑 🧏‍♂ 🧏‍♀ 🧏 🦻 🧏🏻‍♂ 🧏🏼‍♂ 🧏🏽‍♂ 🧏🏾‍♂ 🧏🏿‍♂ 🧏🏻‍♀ 🧏🏼‍♀ 🧏🏽‍♀ 🧏🏾‍♀ 🧏🏿‍♀ 🧏🏻 🧏🏼 🧏🏽 🧏🏾 🧏🏿 🦻🏻 🦻🏼 🦻🏽 🦻🏾 🦻🏿 🧏🏻
聋子	聋子 🧏‍♂ 🧏‍♀ 🧏 🦻 🧏🏻‍♂ 🧏🏼‍♂ 🧏🏽‍♂ 🧏🏾‍♂ 🧏🏿‍♂ 🧏🏻‍♀ 🧏🏼‍♀ 🧏🏽‍♀ 🧏🏾‍♀ 🧏🏿‍♀ 🧏🏻 🧏🏼 🧏🏽 🧏🏾 🧏🏿 🦻🏻 🦻🏼 🦻🏽 🦻🏾 🦻🏿 🧏🏻
龍	龍 🐉 🐲 🐉
龍鳳胎	龍鳳胎 👨‍👩‍👧‍👦
龍捲風	龍捲風 🌀 🌪 🌪️
龍臉	龍臉 🐲
龍年	龍年 🐲
龍頭	龍頭 🐲
龍蝦	龍蝦 🦞
楼房	楼房 🏠
樓房	樓房 🏠
卢安达	卢安达 🇷🇼
卢森堡	卢森堡 🇱🇺
卢旺达	卢旺达 🇷🇼
盧安達	盧安達 🇷🇼
盧森堡	盧森堡 🇱🇺
盧旺達	盧旺達 🇷🇼
卤煮	卤煮 🍢
滷煮	滷煮 🍢
录像	录像 🎦 📹 🎦
录像带	录像带 📼
录像机	录像机 📹
录音带	录音带 📼
录影	录影 📹
录影带	录影带 📼
录影机	录影机 📹
鹿	鹿 🦌
路	路 🛣
路口	路口 🚥 🚦
路人	路人 🚶
路障	路障 🚧
錄像	錄像 🎦 📹 🎦
錄像帶	錄像帶 📼
錄像機	錄像機 📹
錄音帶	錄音帶 📼
錄影	錄影 📹
錄影帶	錄影帶 📼
錄影機	錄影機 📹
露齿大笑	露齿大笑 😁
露齿而笑	露齿而笑 😁
露齒大笑	露齒大笑 😁
露齒而笑	露齒而笑 😁
露宿	露宿 ⛺ △ ⛺️
露营	露营 🏕 ⛺ 🏕️
露營	露營 ⛺ 🏕 🏕️
乱讲	乱讲 🤥
乱噏	乱噏 🤥
亂講	亂講 🤥
亂噏	亂噏 🤥
轮船	轮船 🚢 🛳 🛳️
轮渡	轮渡 ⛴ ⛴️
轮椅	轮椅 ♿ 🦽 🦼 👨‍🦽 👩‍🦽 🧑‍🦽 👨‍🦼 👩‍🦼 🧑‍🦼 👨🏻‍🦽 👨🏼‍🦽 👨🏽‍🦽 👨🏾‍🦽 👨🏿‍🦽 👩🏻‍🦽 👩🏼‍🦽 👩🏽‍🦽 👩🏾‍🦽 👩🏿‍🦽 🧑🏻‍🦽 🧑🏼‍🦽 🧑🏽‍🦽 🧑🏾‍🦽 🧑🏿‍🦽 👨🏻‍🦼 👨🏼‍🦼 👨🏽‍🦼 👨🏾‍🦼 👨🏿‍🦼 👩🏻‍🦼 👩🏼‍🦼 👩🏽‍🦼 👩🏾‍🦼 👩🏿‍🦼 🧑🏻‍🦼 🧑🏼‍🦼 🧑🏽‍🦼 🧑🏾‍🦼 🧑🏿‍🦼 ♿️ 🦽
輪船	輪船 🚢 🛳 🛳️
輪渡	輪渡 ⛴ ⛴️
輪椅	輪椅 ♿ ♿️ 🦽
罗马尼亚	罗马尼亚 🇷🇴
罗马数字	罗马数字 ⅰ ⅱ ⅲ ⅳ ⅴ ⅵ ⅶ ⅷ ⅸ ⅹ ⅺ ⅻ ⅼ ⅽ ⅾ ⅿ
镙丝	镙丝 🔩
螺	螺 🐚
螺号	螺号 🐚
螺號	螺號 🐚
螺母及螺栓	螺母及螺栓 🔩
螺栓套件	螺栓套件 🔩
螺丝	螺丝 🔩
螺絲	螺絲 🔩
螺旋桨飞机	螺旋桨飞机 🛩 🛩️
螺旋槳飛機	螺旋槳飛機 🛩 🛩️
羅馬尼亞	羅馬尼亞 🇷🇴
鏍絲	鏍絲 🔩
骆驼	骆驼 🐪 🐫 🦙 🐫
落雪	落雪 🌨 🌨️
落叶	落叶 🍂 🍃
落叶乔木	落叶乔木 🌳
落叶树	落叶树 🌳
落葉	落葉 🍂 🍃
落葉喬木	落葉喬木 🌳
落葉樹	落葉樹 🌳
吕宋	吕宋 🇵🇭
呂宋	呂宋 🇵🇭
旅馆	旅馆 🏨 🏩 🛌 🛌🏻
旅舘	旅舘 🛌 🛌🏻
旅館	旅館 🏨
旅行	旅行 ✈
旅舍	旅舍 🛌 🛌🏻
律师	律师 👨🏻‍⚖ 👩🏻‍⚖ 🧑🏻‍⚖️
律師	律師 👨🏻‍⚖ 👩🏻‍⚖ 🧑🏻‍⚖️
绿菜	绿菜 🥬
绿茶	绿茶 🍵
绿色	绿色 ♻ ♻️ 🟩
绿色书本	绿色书本 📗
绿色心形	绿色心形 💚
绿心	绿心 💚
绿叶	绿叶 🍃
绿藻	绿藻 🦠
綠菜	綠菜 🥬
綠茶	綠茶 🍵
綠色	綠色 ♻ ♻️ 🟩
綠色書本	綠色書本 📗
綠色心形	綠色心形 💚
綠心	綠心 💚
綠葉	綠葉 🍃
綠藻	綠藻 🦠
妈	妈 👩 👩🏻 👩🏻
妈屄	妈屄 🤬
妈的	妈的 🤬
妈妈	妈妈 👩 👩🏻 👩🏻
妈咪	妈咪 👩 👩🏻 👩🏻
媽	媽 👩 👩🏻 👩🏻
媽屄	媽屄 🤬
媽的	媽的 🤬
媽媽	媽媽 👩 👩🏻 👩🏻
媽咪	媽咪 👩 👩🏻 👩🏻
麻烦	麻烦 🤦🏻‍♀ 🤦🏻‍♂ 🤦🏻
麻煩	麻煩 🤦🏻‍♀ 🤦🏻‍♂ 🤦🏻
麻将	麻将 🀀 🀁 🀂 🀃 🀄 🀅 🀆 🀇 🀈 🀉 🀊 🀋 🀌 🀍 🀎 🀏 🀐 🀑 🀒 🀓 🀔 🀕 🀖 🀗 🀘 🀙 🀚 🀛 🀜 🀝 🀞 🀟 🀠 🀡 🀢 🀣 🀤 🀥 🀦 🀧 🀨 🀩 🀪 🀫 🀄️
麻將	麻將 🀄 🀄️
麻雀	麻雀 🀄 🀄️
马	马 🐎 🐴 🐎
马达加斯加	马达加斯加 🇲🇬
马丁尼克	马丁尼克 🇲🇶
马恩岛	马恩岛 🇮🇲
马尔代夫	马尔代夫 🇲🇻
马尔地夫	马尔地夫 🇲🇻
马尔他	马尔他 🇲🇹
马耳他	马耳他 🇲🇹
马蜂	马蜂 🐝
马拉烕	马拉烕 🇲🇼
马拉维	马拉维 🇲🇼
马来西亚	马来西亚 🇲🇾
马里	马里 🇲🇱
马利	马利 🇲🇱
马脸	马脸 🐴
马铃薯	马铃薯 🥔
马𤠑	马𤠑 🐒
马年	马年 🐴
马其顿	马其顿 🇲🇰
马肉	马肉 🐎 🐎 🐎
马绍尔群岛	马绍尔群岛 🇲🇭
马术	马术 🏇 🏇🏻 🏇🏻
马提尼克	马提尼克 🇲🇶
马桶	马桶 🚽
马头	马头 🐴 🐴 🐴
马戏	马戏 🤹‍♂ 🤹‍ 🤹‍♀ 🤹🏻‍♂ 🤹🏼‍♂ 🤹🏽‍♂ 🤹🏾‍♂ 🤹🏿‍♂ 🤹🏻 🤹🏼 🤹🏽 🤹🏾 🤹🏿 🤹🏻‍♀ 🤹🏼‍♀ 🤹🏽‍♀ 🤹🏾‍♀ 🤹🏿‍♀ 🎪 🎪
马戏团	马戏团 🎪 🤡
马约特	马约特 🇾🇹
码表	码表 ⏱ ⏱️
码农	码农 👨🏻‍💻
码头	码头 ⚓ ⛵ ⚓️
蚂蚁	蚂蚁 🐜
蚂蚱	蚂蚱 🦗
馬	馬 🐎 🐴 🐎
馬達加斯加	馬達加斯加 🇲🇬
馬丁尼克	馬丁尼克 🇲🇶
馬恩島	馬恩島 🇮🇲
馬爾代夫	馬爾代夫 🇲🇻
馬爾地夫	馬爾地夫 🇲🇻
馬爾他	馬爾他 🇲🇹
馬蜂	馬蜂 🐝
馬拉烕	馬拉烕 🇲🇼
馬拉威	馬拉威 🇲🇼
馬拉維	馬拉維 🇲🇼
馬來西亞	馬來西亞 🇲🇾
馬里	馬里 🇲🇱
馬利	馬利 🇲🇱
馬臉	馬臉 🐴
馬鈴薯	馬鈴薯 🥔
馬𤠑	馬𤠑 🐒
馬年	馬年 🐴
馬其頓	馬其頓 🇲🇰
馬肉	馬肉 🐎 🐎 🐎
馬紹爾群島	馬紹爾群島 🇲🇭
馬術	馬術 🏇 🏇🏻 🏇🏻
馬提尼克	馬提尼克 🇲🇶
馬桶	馬桶 🚽
馬頭	馬頭 🐴 🐴 🐴
馬戲	馬戲 🎪
馬戲團	馬戲團 🎪 🤡
馬約特	馬約特 🇾🇹
碼錶	碼錶 ⏱ ⏱️
碼農	碼農 👨🏻‍💻
碼頭	碼頭 ⚓ ⛵ ⚓️
螞蟻	螞蟻 🐜
螞蚱	螞蚱 🦗
骂	骂 🤬
骂人	骂人 🤬
睰睰	睰睰 💤
霾	霾 🌫 🌫️
嘪	嘪 😟
麦	麦 🎙 🎤 🎙️ 🎤️
麦克风	麦克风 🎤 🎙 🎙️ 🎤️
卖萌	卖萌 🐶 💠 😊 🥰 💠 😊 🥰
卖艺	卖艺 🤹🏻‍♀ 🤹🏻‍♂ 🤹🏻
麥	麥 🎙 🎤 🎙️ 🎤️
麥克風	麥克風 🎙 🎤 🎙️ 🎤️
賣萌	賣萌 🐶 💠 😊 🥰 💠 😊 🥰
賣藝	賣藝 🤹🏻‍♀ 🤹🏻‍♂ 🤹🏻
満	満 🈵 🈵️
满	满 🈵 🈵️
满分	满分 💯
满月	满月 🌕 🌝 🌕
滿	滿 🈵 🈵️
滿分	滿分 💯
滿月	滿月 🌕 🌝 🌕
曼岛	曼岛 🇮🇲
曼島	曼島 🇮🇲
曼哈顿	曼哈顿 🗽
曼哈頓	曼哈頓 🗽
漫步	漫步 🚶 🚶🏻‍♀ 🚶🏻‍♂ 🚶🏻
慢走	慢走 🚶 🚶🏻‍♀ 🚶🏻‍♂ 🚶🏻
芒果	芒果 🥭
杧	杧 🥭
杧果	杧果 🥭
盲人	盲人 👨‍🦯 👩‍🦯 🧑‍🦯 🦯 👨🏻‍🦯 👨🏼‍🦯 👨🏽‍🦯 👨🏾‍🦯 👨🏿‍🦯 👩🏻‍🦯 👩🏼‍🦯 👩🏽‍🦯 👩🏾‍🦯 👩🏿‍🦯 🧑🏻‍🦯 🧑🏼‍🦯 🧑🏽‍🦯 🧑🏾‍🦯 🧑🏿‍🦯 🧑🏻‍🦯
盲杖	盲杖 🦯
茫然	茫然 😳
猫	猫 🐈 🐱 😺 😸 😹 😻 😼 😽 🙀 😿 😾 🐈
猫脸	猫脸 🐱 🙀
猫咪	猫咪 🐈
猫年	猫年 🐱
猫肉	猫肉 🐈
猫头	猫头 🐱
猫头鹰	猫头鹰 🦉 𓅓 𓅔 🦉
猫熊	猫熊 🐼
貓	貓 🐈 🐱 🐈
貓臉	貓臉 🐱 🙀
貓咪	貓咪 🐈
貓年	貓年 🐱
貓肉	貓肉 🐈
貓頭	貓頭 🐱
貓頭鷹	貓頭鷹 🦉
貓熊	貓熊 🐼
毛虫	毛虫 🐛
毛蟲	毛蟲 🐛
毛里求斯	毛里求斯 🇲🇺
毛里塔尼亚	毛里塔尼亚 🇲🇷
毛里塔尼亞	毛里塔尼亞 🇲🇷
毛毛虫	毛毛虫 🐛
毛毛蟲	毛毛蟲 🐛
毛线	毛线 🧶
毛线团	毛线团 🧶
毛線	毛線 🧶
毛線團	毛線團 🧶
茅房	茅房 🚾 🚾 🛖
茅利塔尼亚	茅利塔尼亚 🇲🇷
茅利塔尼亞	茅利塔尼亞 🇲🇷
锚	锚 ⚓ ⚓️
錨	錨 ⚓ ⚓️
冇眼睇	冇眼睇 🙈
冒号	冒号 ： :
冒冷汗	冒冷汗 😅 😰
帽	帽 👒 🎩 🎓 🧢 ⛑ 👲 👒 🧢 🎩 🎓 ⛑ 🪖
帽子	帽子 👒 🎩 🎓 🧢 ⛑ 👲 👒 🧢 🎩 🎓 ⛑ 🪖
沒辦法	沒辦法 👐
沒了	沒了 😖
沒臉見人	沒臉見人 🙈
沒門	沒門 🙅 🙅🏻‍♀ 🙅🏻‍♂ 🙅🏻
沒錢	沒錢 💸
沒錢了	沒錢了 💸
沒事的	沒事的 🤗
沒說	沒說 🙊
沒聽看	沒聽看 🙉
沒問題	沒問題 🆗 👌 👌🏻 👌🏻
沒戲	沒戲 😔
沒想好	沒想好 😕
沒興趣	沒興趣 😌
沒眼看	沒眼看 🙈
沒意思	沒意思 😞 😴
沒有	沒有 🈚
沒有來信	沒有來信 📭
沒有新郵件	沒有新郵件 📬
沒有郵件	沒有郵件 📪
没办法	没办法 👐
没了	没了 😖
没脸	没脸 🤦‍♂ 🤦 🤦‍♀ 🤦🏻‍♂ 🤦🏼‍♂ 🤦🏽‍♂ 🤦🏾‍♂ 🤦🏿‍♂ 🤦🏻 🤦🏼 🤦🏽 🤦🏾 🤦🏻‍♀ 🤦🏼‍♀ 🤦🏽‍♀ 🤦🏾‍♀ 🤦🏿‍♀
没脸见人	没脸见人 🙈
没门	没门 🙅 🙅🏻‍♀ 🙅🏻‍♂ 🙅🏻
没钱	没钱 💸
没钱了	没钱了 💸
没事的	没事的 🤗
没说	没说 🙊
没听看	没听看 🙉
没问题	没问题 🆗 👌 👌🏻 👌🏻
没戏	没戏 😔
没想好	没想好 😕
没兴趣	没兴趣 😌
没眼看	没眼看 🙈
没意思	没意思 😞 😴
没有	没有 🈚
没有来信	没有来信 📭
没有新邮件	没有新邮件 📬
没有邮件	没有邮件 📪
玫瑰	玫瑰 🌹 🥀
玫瑰王国	玫瑰王国 🇧🇬
玫瑰王國	玫瑰王國 🇧🇬
眉月	眉月 🌒
梅	梅 🀢
梅花	梅花 ♣ ♧ 🀢 🌸 ♣️ 🌸
梅花鹿	梅花鹿 🦌
梅利利亚	梅利利亚 🇪🇦
媒体	媒体 📺 📻
媒體	媒體 📺 📻
美钞	美钞 💵
美鈔	美鈔 💵
美刀	美刀 💵
美国	美国 🇺🇸 美利坚合众国 🗽 🇺🇸
美国国旗	美国国旗 🇺🇸
美國	美國 🇺🇸 🗽 🇺🇸
美國國旗	美國國旗 🇺🇸
美甲	美甲 💅 💅🏻 💅🏻
美金	美金 💲 💵 💵
美利坚	美利坚 🇺🇸
美利堅	美利堅 🇺🇸
美男鱼	美男鱼 🧜🏻‍♂
美男魚	美男魚 🧜🏻‍♂
美女	美女 😍 😻
美人鱼	美人鱼 🧜‍♂ 🧜 🧜‍♀ 🧜🏻‍♂ 🧜🏼‍♂ 🧜🏽‍♂ 🧜🏾‍♂ 🧜🏿‍♂ 🧜🏻 🧜🏼 🧜🏽 🧜🏾 🧜🏿 🧜🏻‍♀ 🧜🏼‍♀ 🧜🏽‍♀ 🧜🏾‍♀ 🧜🏿‍♀ 🧜🏻‍♀️
美人魚	美人魚 🧜🏻‍♀ 🧜🏻‍♀️
美容	美容 💆
美式橄榄球	美式橄榄球 🏈
美式橄欖球	美式橄欖球 🏈
美式九球	美式九球 🎱
美式足球	美式足球 🏈
美属萨摩亚	美属萨摩亚 🇦🇸
美属维京群岛	美属维京群岛 🇻🇮
美屬薩摩亞	美屬薩摩亞 🇦🇸
美屬維京群島	美屬維京群島 🇻🇮
美味	美味 😋 😍 😻
美元	美元 💵 $ ㌦ 💲 💵
美圆	美圆 💵
美圓	美圓 💵
美洲	美洲 🌎
美洲豹	美洲豹 🐆
美洲驼	美洲驼 🦙
媚眼	媚眼 😉
门	门 🚪
门票	门票 🎟 🎟️
门松	门松 🎍
门卫	门卫 💂 💂🏻‍♀ 💂🏻‍♂ 💂🏻
門	門 🚪
門票	門票 🎟 🎟️
門松	門松 🎍
門衛	門衛 💂 💂🏻‍♀ 💂🏻‍♂ 💂🏻
闷著	闷著 🤐
悶著	悶著 🤐
萌	萌 💠 😊
蒙古	蒙古 🇲🇳
蒙特內哥羅	蒙特內哥羅 🇲🇪
蒙特内哥罗	蒙特内哥罗 🇲🇪
蒙特塞拉特	蒙特塞拉特 🇲🇸
蒙特塞拉特岛	蒙特塞拉特岛 🇲🇸
蒙特色拉特島	蒙特色拉特島 🇲🇸
蒙眼睛	蒙眼睛 🙈
蒙哲腊	蒙哲腊 🇲🇸
蒙哲臘	蒙哲臘 🇲🇸
孟加拉	孟加拉 🇧🇩
孟加拉国	孟加拉国 🇧🇩
孟加拉國	孟加拉國 🇧🇩
眯眼笑	眯眼笑 😄 😆
迷糊	迷糊 🥴
迷你光碟	迷你光碟 💽
迷你光盘	迷你光盘 💽
迷你光盤	迷你光盤 💽
猕猴桃	猕猴桃 🥝
獼猴桃	獼猴桃 🥝
米	米 ㎙ ㎚ ㎛ ㎜ ㎝ ㎞ ㍍
米饼	米饼 🍘
米餅	米餅 🍘
米饭	米饭 🍚
米飯	米飯 🍚
米果	米果 🍘
米字符号	米字符号 ❇
米字符號	米字符號 ❇
米字旗	米字旗 🇬🇧
祕魯	祕魯 🇵🇪
秘	秘 ㊙ ㊙️
秘方	秘方 ㊙
秘鲁	秘鲁 🇵🇪
秘魯	秘魯 🇵🇪
秘密	秘密 🤐 🤭 🙊 ㊙ 👁‍🗨 👁‍🗨
秘钥	秘钥 🗝 🗝️
秘鑰	秘鑰 🗝 🗝️
秘语	秘语 👁‍🗨
秘語	秘語 👁‍🗨
密克罗尼西亚	密克罗尼西亚 🇫🇲
密克羅尼西亞	密克羅尼西亞 🇫🇲
密码	密码 🔏
密碼	密碼 🔏
密钥	密钥 🔐
密鑰	密鑰 🔐
幂	幂 ^
蜜	蜜 🍯
蜜蜂	蜜蜂 🐝 𓆤 🐝
蜜瓜	蜜瓜 🍈
蜜罐	蜜罐 🍯
绵羊	绵羊 🐑
綿羊	綿羊 🐑
免打扰	免打扰 🔕
免打擾	免打擾 🔕
免费	免费 🆓 🆓️
免费电话	免费电话 ➿
免費	免費 🆓 🆓️
免費電話	免費電話 ➿
缅甸	缅甸 🇲🇲
緬甸	緬甸 🇲🇲
面	面 🍜 🍝 🍜
面包	面包 🍞 🥐 🥖 🥨 🥯 🍩 🥮 🍞
面包车	面包车 🚐
面包圈	面包圈 🍩 🥯 🥯
面积	面积 ㎟ ㎠ ㎡ ㎢
面具	面具 🎭 🤿 🎭
面条	面条 🍜 🍝 🍜
麪包	麪包 🍞 🥐 🥖 🥨 🥯 🍩 🥮
麵	麵 🍜
麵包	麵包 🍞
麵包車	麵包車 🚐
麵包圈	麵包圈 🍩 🥯 🥯
麵條	麵條 🍜 🍝 🍜
苗	苗 🌱
秒	秒 〃 ‴ ㎰ ㎱ ㎲ ㎳
秒表	秒表 ⏱ ⏲ ⏱️
秒錶	秒錶 ⏱ ⏱️
庙	庙 🛕
灭火队	灭火队 👨🏻‍🚒 👩🏻‍🚒 🧑🏻‍🚒
灭火器	灭火器 🧯
滅火隊	滅火隊 👨🏻‍🚒 👩🏻‍🚒 🧑🏻‍🚒
滅火器	滅火器 🧯
民工	民工 👷 👷🏻‍♀ 👷🏻‍♂ 👷🏻
民国	民国 🇹🇼
民國	民國 🇹🇼
民警	民警 👮🏻‍♀ 👮🏻‍♂ 👮🏻
民主刚果	民主刚果 🇨🇩
民主剛果	民主剛果 🇨🇩
抿嘴	抿嘴 😾
名	名 ㊔ ㈴
名牌	名牌 📛
名片制作	名片制作 📇
名片製作	名片製作 📇
名胜	名胜 🗽 🏰 🗼 🗻 🏯 🏝 🏖 🌁 🌉 🏞
名勝	名勝 🗽 🏰 🗼 🗻 🏯 🏝 🏖 🌁 🌉 🏞
明亮	明亮 🌞
明星	明星 🌟 👨🏻‍🎤 👩🏻‍🎤 🌟 🧑🏻‍🎤️
明治	明治 ㍾
命中	命中 🎯
模里西斯	模里西斯 🇲🇺
膜拜	膜拜 🙇‍♂ 🙇‍ 🙇‍♀ 🙇🏻‍♂ 🙇🏼‍♂ 🙇🏽‍♂ 🙇🏾‍♂ 🙇🏿‍♂ 🙇🏻 🙇🏼 🙇🏽 🙇🏾 🙇🏿 🙇🏻‍♀ 🙇🏼‍♀ 🙇🏽‍♀ 🙇🏾‍♀ 🙇🏿‍♀
摩尔	摩尔 ㏖
摩尔多瓦	摩尔多瓦 🇲🇩 🇦🇩 🇦🇩 🇲🇩
摩爾多瓦	摩爾多瓦 🇦🇩 🇲🇩
摩羯座	摩羯座 ♑ ♑️
摩洛哥	摩洛哥 🇲🇦
摩纳哥	摩纳哥 🇲🇨
摩納哥	摩納哥 🇲🇨
摩天轮	摩天轮 🎡
摩天輪	摩天輪 🎡
摩托	摩托 🏍 🏍️
摩托车	摩托车 🏍 🏍️
摩托車	摩托車 🏍 🏍️
摩托艇	摩托艇 🛥 🛥️
蘑菇	蘑菇 🍄
魔法	魔法 🧙🏻‍♀ 🧙🏻‍♂ 🧙🏻
魔法棒	魔法棒 🎇 🎇 🪄
魔法师	魔法师 🧙🏻‍♀ 🧙🏻‍♂ 🧙🏻
魔法師	魔法師 🧙🏻‍♀ 🧙🏻‍♂ 🧙🏻
魔鬼	魔鬼 👹 👺
魔术帽	魔术帽 🎩
魔術帽	魔術帽 🎩
魔头	魔头 🦹🏻‍♀ 🦹🏻‍♂ 🦹🏻
魔頭	魔頭 🦹🏻‍♀ 🦹🏻‍♂ 🦹🏻
魔杖	魔杖 ☤ ‍⚕ 🪄
抹茶	抹茶 🍵
末尾	末尾 🔚
莫三比克	莫三比克 🇲🇿
莫桑比克	莫桑比克 🇲🇿
漠然	漠然 😐 😶 😶
墨镜	墨镜 🕶 😎 🕶️
墨鏡	墨鏡 🕶 😎 🕶️
墨西哥	墨西哥 🇲🇽
墨西哥卷	墨西哥卷 🌯
墨西哥卷饼	墨西哥卷饼 🌯
墨西哥捲	墨西哥捲 🌯
墨西哥捲餅	墨西哥捲餅 🌯
墨鱼	墨鱼 🦑
墨魚	墨魚 🦑
某人	某人 👤
母	母 👩 👩🏻 👩🏻
母鸡	母鸡 🐔
母雞	母雞 🐔
母牛	母牛 🐮
母女	母女 👩‍👧
母女俩	母女俩 👩‍👧
母女倆	母女倆 👩‍👧
母亲	母亲 👩 👩🏻 👩🏻
母親	母親 👩 👩🏻 👩🏻
母子	母子 👩‍👦
母子俩	母子俩 👩‍👦
母子倆	母子倆 👩‍👦
牡蛎	牡蛎 🦪
牡羊座	牡羊座 ♈ ♈️
拇指	拇指 👍 👍🏻 👍🏻
拇指朝下	拇指朝下 👎
木	木 ㊍ ㈭ 🪵
木槿	木槿 🌺
木屋	木屋 🏡
目	目 👁 👁️
目光	目光 👁 👁️
沐浴	沐浴 🛁
沐浴露	沐浴露 🧴
沐浴乳	沐浴乳 🧴
牧羊座	牧羊座 ♈
暮光	暮光 🌆
暮色	暮色 🌆
穆斯林	穆斯林 🧕 👳‍ 👳‍♂ 👳 👳‍♀ 🧕🏻 🧕🏼 🧕🏽 🧕🏾 🧕🏿 👳🏻‍♂ 👳🏼‍♂ 👳🏽‍♂ 👳🏾‍♂ 👳🏿‍♂ 👳🏻 👳🏼 👳🏽 👳🏾 👳🏿 👳🏻‍♀ 👳🏼‍♀ 👳🏽‍♀ 👳🏾‍♀ 👳🏿‍♀ ☪ 🧔🏻 👳🏽 ☪️ 🧕🏾
纳粹	纳粹 卐
纳米	纳米 ㎚
纳米比亚	纳米比亚 🇳🇦
纳扎尔护身符	纳扎尔护身符 🧿
纳扎尔球	纳扎尔球 🧿
纳扎护身符	纳扎护身符 🧿
納米比亞	納米比亞 🇳🇦
納扎爾護身符	納扎爾護身符 🧿
納扎爾球	納扎爾球 🧿
納扎護身符	納扎護身符 🧿
捺	捺 丶
奶	奶 🥛
奶黄	奶黄 🍮
奶黃	奶黃 🍮
奶酪	奶酪 🧀
奶奶	奶奶 👵 👵🏻 👵🏻
奶牛	奶牛 🐄 🐮 🐄
奶瓶	奶瓶 🍼
奶油面包	奶油面包 🥯
奶油麵包	奶油麵包 🥯
奈及利亚	奈及利亚 🇳🇬
奈及利亞	奈及利亞 🇳🇬
男	男 ㊚ ♂ 👨 👨‍🦰 👱‍♂ 👨‍🦳 👨‍🦲 🧔 👴 👲 👯‍♂ 🚹 🧍‍♂ 👨🏻 👨🏼 👨🏽 👨🏾 👨🏿 👨🏻‍🦱 👨🏼‍🦱 👨🏽‍🦱 👨🏾‍🦱 👨🏿‍🦱 👨🏻‍🦰 👨🏼‍🦰 👨🏽‍🦰 👨🏾‍🦰 👨🏿‍🦰 👱🏻‍♂ 👱🏼‍♂ 👱🏽‍♂ 👱🏾‍♂ 👱🏿‍♂ 👨🏻‍🦳 👨🏼‍🦳 👨🏽‍🦳 👨🏾‍🦳 👨🏿‍🦳 👨🏻‍🦲 👨🏼‍🦲 👨🏽‍🦲 👨🏾‍🦲 👨🏿‍🦲 🧔🏻 🧔🏼 🧔🏽 🧔🏾 🧔🏿 👴🏻 👴🏼 👴🏽 👴🏾 👴🏿 👲🏻 👲🏼 👲🏽 👲🏾 👲🏿
男白领	男白领 👨🏻‍💼
男白領	男白領 👨🏻‍💼
男厕	男厕 🚹
男廁	男廁 🚹
男超人	男超人 🦸🏻‍♂
男程序员	男程序员 👨🏻‍💻
男程序員	男程序員 👨🏻‍💻
男厨	男厨 👨🏻‍🍳
男厨师	男厨师 👨🏻‍🍳
男廚	男廚 👨🏻‍🍳
男廚師	男廚師 👨🏻‍🍳
男船長	男船長 👨🏻‍✈
男船长	男船长 👨🏻‍✈
男灯神	男灯神 🧞‍♂
男燈神	男燈神 🧞‍♂
男法官	男法官 👨🏻‍⚖
男法师	男法师 🧙🏻‍♂
男法師	男法師 🧙🏻‍♂
男服务员	男服务员 💁🏻‍♂
男服務員	男服務員 💁🏻‍♂
男歌手	男歌手 👨🏻‍🎤
男歌星	男歌星 👨🏻‍🎤
男工	男工 👨🏻‍🏭
男工程师	男工程师 👷🏻‍♂
男工程師	男工程師 👷🏻‍♂
男工人	男工人 👷🏻‍♂
男孩	男孩 👦 👦🏻 👦🏼 👦🏽 👦🏾 👦🏿 👦🏻
男孩节	男孩节 🎏
男孩節	男孩節 🎏
男行人	男行人 🚶🏻‍♂
男护士	男护士 👨🏻‍⚕
男護士	男護士 👨🏻‍⚕
男划手	男划手 🚣🏻‍♂
男画家	男画家 👨🏻‍🎨
男畫家	男畫家 👨🏻‍🎨
男机长	男机长 👨🏻‍✈
男機長	男機長 👨🏻‍✈
男技工	男技工 👨🏻‍🔧
男技师	男技师 👨🏻‍🔧
男技師	男技師 👨🏻‍🔧
男间谍	男间谍 🕵🏻‍♂
男間諜	男間諜 🕵🏻‍♂
男舰长	男舰长 👨🏻‍✈
男艦長	男艦長 👨🏻‍✈
男僵尸	男僵尸 🧟‍♂
男殭屍	男殭屍 🧟‍♂
男精怪	男精怪 🧙🏻‍♂ 🧝🏻‍♂ 🧛🏻‍♂ 🧟‍♂ 🧞‍♂ 🧜🏻‍♂ 🧚🏻‍♂ 🦹🏻‍♂
男精灵	男精灵 🧝🏻‍♂
男精靈	男精靈 🧝🏻‍♂
男看守	男看守 💂🏻‍♂
男科学家	男科学家 👨🏻‍🔬
男科學家	男科學家 👨🏻‍🔬
男老师	男老师 👨🏻‍🏫
男老師	男老師 👨🏻‍🏫
男律师	男律师 👨🏻‍⚖
男律師	男律師 👨🏻‍⚖
男门卫	男门卫 💂🏻‍♂
男門衛	男門衛 💂🏻‍♂
男民工	男民工 👷🏻‍♂
男民警	男民警 👮🏻‍♂
男明星	男明星 👨🏻‍🎤
男魔头	男魔头 🦹🏻‍♂
男魔頭	男魔頭 🦹🏻‍♂
男穆斯林	男穆斯林 🧔🏻
男球员	男球员 ⛹🏻‍♂
男球員	男球員 ⛹🏻‍♂
男人	男人 👨 👨‍🦰 👱‍♂ 👨‍🦳 👨‍🦲 🧔 👴 👲 👯‍♂ 🚹 🧍‍♂ 👨🏻 👨🏼 👨🏽 👨🏾 👨🏿 👨🏻‍🦱 👨🏼‍🦱 👨🏽‍🦱 👨🏾‍🦱 👨🏿‍🦱 👨🏻‍🦰 👨🏼‍🦰 👨🏽‍🦰 👨🏾‍🦰 👨🏿‍🦰 👱🏻‍♂ 👱🏼‍♂ 👱🏽‍♂ 👱🏾‍♂ 👱🏿‍♂ 👨🏻‍🦳 👨🏼‍🦳 👨🏽‍🦳 👨🏾‍🦳 👨🏿‍🦳 👨🏻‍🦲 👨🏼‍🦲 👨🏽‍🦲 👨🏾‍🦲 👨🏿‍🦲 🧔🏻 🧔🏼 🧔🏽 🧔🏾 🧔🏿 👴🏻 👴🏼 👴🏽 👴🏾 👴🏿 👲🏻 👲🏼 👲🏽 👲🏾 👲🏿 👨🏻
男神探	男神探 🕵🏻‍♂
男士	男士 🚹
男士鞋	男士鞋 👞
男守卫	男守卫 💂🏻‍♂
男守衛	男守衛 💂🏻‍♂
男双胞胎	男双胞胎 👨‍👩‍👦‍👦
男雙胞胎	男雙胞胎 👨‍👩‍👦‍👦
男太空人	男太空人 👨🏻‍🚀
男探長	男探長 🕵🏻‍♂
男探长	男探长 🕵🏻‍♂
男同	男同 👨‍❤‍👨 👨🏻‍❤️‍👨🏻
男同性恋	男同性恋 👨‍❤‍👨 👬 👨🏻‍❤️‍👨🏻 👬🏻
男同性戀	男同性戀 👨‍❤‍👨 👬 👨🏻‍❤️‍👨🏻 👬🏻
男同学	男同学 👨🏻‍🎓
男同學	男同學 👨🏻‍🎓
男童	男童 👦 👦🏻 👦🏻
男卫士	男卫士 💂🏻‍♂
男衛士	男衛士 💂🏻‍♂
男吸血鬼	男吸血鬼 🧛🏻‍♂
男消防员	男消防员 👨🏻‍🚒
男消防員	男消防員 👨🏻‍🚒
男鞋	男鞋 👞
男星	男星 👨🏻‍🎤 👨🏻‍🎤️
男性	男性 🚹
男靴	男靴 🥾
男学生	男学生 👨🏻‍🎓
男學生	男學生 👨🏻‍🎓
男医生	男医生 👨🏻‍⚕
男醫生	男醫生 👨🏻‍⚕
男艺人	男艺人 👨🏻‍🎨
男艺术家	男艺术家 👨🏻‍🎨
男藝人	男藝人 👨🏻‍🎨
男藝術家	男藝術家 👨🏻‍🎨
男英雄	男英雄 🦸🏻‍♂
男宇航员	男宇航员 👨🏻‍🚀
男宇航員	男宇航員 👨🏻‍🚀
男仔	男仔 👦 👦🏻 👦🏻
男侦探	男侦探 🕵🏻‍♂
男偵探	男偵探 🕵🏻‍♂
男职员	男职员 👨🏻‍💼
男職員	男職員 👨🏻‍💼
男装	男装 👕
男裝	男裝 👕
男状师	男状师 👨🏻‍⚖
男狀師	男狀師 👨🏻‍⚖
男子	男子 👨 👨🏻 👨🏻
男子体操	男子体操 🤸🏻‍♂
男子體操	男子體操 🤸🏻‍♂
南	南 🀁
南朝鲜	南朝鲜 🇰🇷
南朝鮮	南朝鮮 🇰🇷
南非	南非 🇿🇦
南瓜	南瓜 🎃
南瓜灯	南瓜灯 🎃
南瓜灯笼	南瓜灯笼 🎃
南瓜燈	南瓜燈 🎃
南瓜燈籠	南瓜燈籠 🎃
南瓜脸	南瓜脸 🎃
南瓜臉	南瓜臉 🎃
南瓜人	南瓜人 🎃
南韩	南韩 🇰🇷
南韓	南韓 🇰🇷
南极	南极 🇦🇶
南极洲	南极洲 🇦🇶
南極	南極 🇦🇶
南極洲	南極洲 🇦🇶
南帽	南帽 🎩
南美探戈	南美探戈 🇦🇷
南乔治亚和南桑威奇群岛	南乔治亚和南桑威奇群岛 🇬🇸
南乔治亚与南三明治群岛	南乔治亚与南三明治群岛 🇬🇸
南喬治亞和南桑威奇群島	南喬治亞和南桑威奇群島 🇬🇸
南喬治亞與南三明治群島	南喬治亞與南三明治群島 🇬🇸
南苏丹	南苏丹 🇸🇸
南苏丹共和国	南苏丹共和国 🇸🇸
南蘇丹	南蘇丹 🇸🇸
南蘇丹共和國	南蘇丹共和國 🇸🇸
难吃	难吃 🤢
难过	难过 😔 😥 😫 😩 ☹ 😭 😔 😩 😭
难受	难受 😣 😫 😩 🤕 🤕
难题	难题 🤔
难想	难想 🤔
難喫	難喫 🤢
難過	難過 😔 😩 😫 😭 😔 😩 😭
難受	難受 🤕
難題	難題 🤔
難想	難想 🤔
馕	馕 🥙
饢	饢 🥙
脑	脑 🧠
脑子	脑子 🧠
瑙鲁	瑙鲁 🇳🇷
瑙魯	瑙魯 🇳🇷
腦	腦 🧠
腦子	腦子 🧠
闹铃	闹铃 ⏰ 🔔
闹心	闹心 😠
闹钟	闹钟 ⏰ 🔔
鬧鈴	鬧鈴 ⏰ 🔔
鬧心	鬧心 😠
鬧鐘	鬧鐘 ⏰ 🔔
内裤	内裤 🩲
能见度低	能见度低 🌁
能見度低	能見度低 🌁
尼泊尔	尼泊尔 🇳🇵
尼泊爾	尼泊爾 🇳🇵
尼加拉瓜	尼加拉瓜 🇳🇮
尼日	尼日 🇳🇪
尼日尔	尼日尔 🇳🇪
尼日爾	尼日爾 🇳🇪
尼日利亚	尼日利亚 🇳🇬
尼日利亞	尼日利亞 🇳🇬
婗	婗 👧 👧🏻 👧🏻
你猜	你猜 😏 😼
你大爷	你大爷 🤬
你大爺	你大爺 🤬
你好	你好 👋 🙂 👋🏻 👋🏼 👋🏽 👋🏾 👋🏿 🙂
你妈	你妈 🤬
你妈屄	你妈屄 🤬
你媽	你媽 🤬
你媽屄	你媽屄 🤬
你妹	你妹 😤 🤬 🤬
你也是	你也是 😏 😼
逆	逆 ¬
匿名	匿名 👤
念珠	念珠 📿
鸟	鸟 🐦 🦆 🦅 🦉 🦇 🐓 🦃 🕊 🐧 🦚 🦜 𓅡 𓅬 🦆 🦅 🦉 🦇 🐓 🦃 🕊 🐧 🐦 🦚 🦜 🦩 🦤
鸟居	鸟居 ⛩
鸟类	鸟类 🐦
鳥	鳥 🐦 🦆 🦅 🦉 🦇 🐓 🦃 🕊 🐧 🦚 🦜 🦆 🦅 🦉 🦇 🐓 🦃 🕊 🐧 🐦 🦚 🦜 🦩 🦤
鳥類	鳥類 🐦
柠檬	柠檬 🍋
檸檬	檸檬 🍋
牛	牛 🐂 🐃 🐄 🐮 𓃾 🐂 🐃 🐄 🦬
牛顿	牛顿 艾萨克·牛顿 Isaac Newton
牛耳饼	牛耳饼 🍥
牛耳餅	牛耳餅 🍥
牛脸	牛脸 🐮
牛臉	牛臉 🐮
牛奶	牛奶 🥛
牛年	牛年 🐮
牛排	牛排 🥩
牛肉	牛肉 🐂
牛乳	牛乳 🥛
牛市	牛市 📈
牛头	牛头 🐮
牛頭	牛頭 🐮
牛油果	牛油果 🥑
牛仔	牛仔 🤠
牛仔裤	牛仔裤 👖
牛仔褲	牛仔褲 👖
纽埃	纽埃 🇳🇺
纽西兰	纽西兰 🇳🇿
纽约	纽约 🗽
紐埃	紐埃 🇳🇺
紐西蘭	紐西蘭 🇳🇿
紐約	紐約 🗽
农夫	农夫 👨🏻‍🌾
农户	农户 👨🏻‍🌾 👩🏻‍🌾 🧑🏻‍🌾
农民	农民 👨‍🌾 🧑‍🌾 👩‍🌾 👨🏻‍🌾 👨🏼‍🌾 👨🏽‍🌾 👨🏾‍🌾 👨🏿‍🌾 🧑🏻‍🌾 🧑🏼‍🌾 🧑🏽‍🌾 🧑🏾‍🌾 🧑🏿‍🌾 👩🏻‍🌾 👩🏼‍🌾 👩🏽‍🌾 👩🏾‍🌾 👩🏿‍🌾 🧑🏻‍🌾
农民工	农民工 👷 👷🏻‍♀ 👷🏻‍♂ 👷🏻
浓汤	浓汤 🍲
農夫	農夫 👨🏻‍🌾
農戶	農戶 👨🏻‍🌾 👩🏻‍🌾 🧑🏻‍🌾
農民	農民 👨🏻‍🌾 👩🏻‍🌾 🧑🏻‍🌾
農民工	農民工 👷 👷🏻‍♀ 👷🏻‍♂ 👷🏻
濃湯	濃湯 🍲
怒	怒 😡
怒目	怒目 😾
挪威	挪威 🇳🇴
诺贝尔奖	诺贝尔奖 诺贝尔物理学奖 诺贝尔化学奖 诺贝尔生理学或医学奖 诺贝尔文学奖 诺贝尔经济学奖 诺贝尔和平奖
诺福克岛	诺福克岛 🇳🇫
诺鲁	诺鲁 🇳🇷
諾福克島	諾福克島 🇳🇫
諾魯	諾魯 🇳🇷
糥米丸子	糥米丸子 🍡
女	女 ㊛ ♀ 👩 🧑 👩‍🦱 👩‍🦰 👱‍♀ 👩‍🦳 👩‍🦲 👵 🧓 👯‍♀ 🚺 🧍‍♀ 👩🏻 👩🏼 👩🏽 👩🏾 👩🏿 🧑🏻 🧑🏼 🧑🏽 🧑🏾 🧑🏿 👩🏻‍🦱 👩🏼‍🦱 👩🏽‍🦱 👩🏾‍🦱 👩🏿‍🦱 👩🏻‍🦰 👩🏼‍🦰 👩🏽‍🦰 👩🏾‍🦰 👩🏿‍🦰 👱🏻‍♀ 👱🏼‍♀ 👱🏽‍♀ 👱🏾‍♀ 👱🏿‍♀ 👩🏻‍🦳 👩🏼‍🦳 👩🏽‍🦳 👩🏾‍🦳 👩🏿‍🦳 👩🏻‍🦲 👩🏼‍🦲 👩🏽‍🦲 👩🏾‍🦲 👩🏿‍🦲 👵🏻 👵🏼 👵🏽 👵🏾 👵🏿 🧓🏻 🧓🏼 🧓🏽 🧓🏾 🧓🏿
女白领	女白领 👩🏻‍💼
女白領	女白領 👩🏻‍💼
女厕	女厕 🚺
女廁	女廁 🚺
女超人	女超人 🦸🏻‍♀
女程序员	女程序员 👩🏻‍💻
女程序員	女程序員 👩🏻‍💻
女厨	女厨 👩🏻‍🍳
女厨师	女厨师 👩🏻‍🍳
女廚	女廚 👩🏻‍🍳
女廚師	女廚師 👩🏻‍🍳
女船長	女船長 👩🏻‍✈
女船长	女船长 👩🏻‍✈
女灯神	女灯神 🧞‍♀
女燈神	女燈神 🧞‍♀
女儿	女儿 👧 👨‍👩‍👧 👧🏻 👧🏻 👨‍👩‍👧
女儿节	女儿节 🎎
女兒	女兒 👧 👨‍👩‍👧 👧🏻 👧🏻 👨‍👩‍👧
女兒節	女兒節 🎎
女法官	女法官 👩🏻‍⚖
女法师	女法师 🧙🏻‍♀
女法師	女法師 🧙🏻‍♀
女服务员	女服务员 💁🏻‍♀
女服務員	女服務員 💁🏻‍♀
女歌手	女歌手 👩🏻‍🎤
女歌星	女歌星 👩🏻‍🎤
女工	女工 👩🏻‍🏭
女工程师	女工程师 👷🏻‍♀
女工程師	女工程師 👷🏻‍♀
女工人	女工人 👷🏻‍♀
女孩	女孩 👧 🧒 👧🏻 👧🏼 👧🏽 👧🏾 👧🏿 🧒🏻 🧒🏼 🧒🏽 🧒🏾 🧒🏿 👧🏻
女行人	女行人 🚶🏻‍♀
女护士	女护士 👩🏻‍⚕
女護士	女護士 👩🏻‍⚕
女划手	女划手 🚣🏻‍♀
女画家	女画家 👩🏻‍🎨
女畫家	女畫家 👩🏻‍🎨
女机长	女机长 👩🏻‍✈
女機長	女機長 👩🏻‍✈
女技工	女技工 👩🏻‍🔧
女技师	女技师 👩🏻‍🔧
女技師	女技師 👩🏻‍🔧
女间谍	女间谍 🕵🏻‍♀
女間諜	女間諜 🕵🏻‍♀
女舰长	女舰长 👩🏻‍✈
女艦長	女艦長 👩🏻‍✈
女僵尸	女僵尸 🧟‍♀
女殭屍	女殭屍 🧟‍♀
女精怪	女精怪 🧙🏻‍♀ 🧝🏻‍♀ 🧛🏻‍♀ 🧟‍♀ 🧞‍♀ 🧜🏻‍♀ 🧚🏻‍♀ 🦹🏻‍♀
女精灵	女精灵 🧝🏻‍♀
女精靈	女精靈 🧝🏻‍♀
女警	女警 👮🏻‍♀
女看守	女看守 💂🏻‍♀
女科学家	女科学家 👩🏻‍🔬
女科學家	女科學家 👩🏻‍🔬
女老师	女老师 👩🏻‍🏫
女老師	女老師 👩🏻‍🏫
女律师	女律师 👩🏻‍⚖
女律師	女律師 👩🏻‍⚖
女帽	女帽 👒
女门卫	女门卫 💂🏻‍♀
女門衛	女門衛 💂🏻‍♀
女民工	女民工 👷🏻‍♀
女民警	女民警 👮🏻‍♀
女明星	女明星 👩🏻‍🎤
女魔头	女魔头 🦹🏻‍♀
女魔頭	女魔頭 🦹🏻‍♀
女穆斯林	女穆斯林 🧕🏻 🧕🏾
女农民	女农民 👩🏻‍🌾
女農民	女農民 👩🏻‍🌾
女球员	女球员 ⛹🏻‍♀
女球員	女球員 ⛹🏻‍♀
女人	女人 👩 🧑 👩‍🦱 👩‍🦰 👱‍♀ 👩‍🦳 👩‍🦲 👵 🧓 👯‍♀ 🚺 🧍‍♀ 👩🏻 👩🏼 👩🏽 👩🏾 👩🏿 🧑🏻 🧑🏼 🧑🏽 🧑🏾 🧑🏿 👩🏻‍🦱 👩🏼‍🦱 👩🏽‍🦱 👩🏾‍🦱 👩🏿‍🦱 👩🏻‍🦰 👩🏼‍🦰 👩🏽‍🦰 👩🏾‍🦰 👩🏿‍🦰 👱🏻‍♀ 👱🏼‍♀ 👱🏽‍♀ 👱🏾‍♀ 👱🏿‍♀ 👩🏻‍🦳 👩🏼‍🦳 👩🏽‍🦳 👩🏾‍🦳 👩🏿‍🦳 👩🏻‍🦲 👩🏼‍🦲 👩🏽‍🦲 👩🏾‍🦲 👩🏿‍🦲 👵🏻 👵🏼 👵🏽 👵🏾 👵🏿 🧓🏻 🧓🏼 🧓🏽 🧓🏾 🧓🏿 👩🏻
女神探	女神探 🕵🏻‍♀
女士	女士 🚺
女士服装	女士服装 👚
女士服裝	女士服裝 👚
女士帽	女士帽 👒
女守卫	女守卫 💂🏻‍♀
女守衛	女守衛 💂🏻‍♀
女双胞胎	女双胞胎 👨‍👩‍👧‍👧
女雙胞胎	女雙胞胎 👨‍👩‍👧‍👧
女太空人	女太空人 👩🏻‍🚀
女探長	女探長 🕵🏻‍♀
女探长	女探长 🕵🏻‍♀
女同	女同 👩‍❤‍👩 👩🏻‍❤️‍👩🏻
女同性恋	女同性恋 👩‍❤‍👩 👭 👩🏻‍❤️‍👩🏻 👭🏻
女同性戀	女同性戀 👩‍❤‍👩 👭 👩🏻‍❤️‍👩🏻 👭🏻
女同学	女同学 👩🏻‍🎓
女同學	女同學 👩🏻‍🎓
女童	女童 👧 👧🏻 👧🏻
女王	女王 👸 👸🏻 👸🏻
女卫士	女卫士 💂🏻‍♀
女衛士	女衛士 💂🏻‍♀
女吸血鬼	女吸血鬼 🧛🏻‍♀
女消防员	女消防员 👩🏻‍🚒
女消防員	女消防員 👩🏻‍🚒
女鞋	女鞋 👠
女星	女星 👩🏻‍🎤 👩🏻‍🎤️
女性	女性 🚺
女学生	女学生 👩🏻‍🎓
女學生	女學生 👩🏻‍🎓
女医生	女医生 👩🏻‍⚕
女醫生	女醫生 👩🏻‍⚕
女艺人	女艺人 👩🏻‍🎨
女艺术家	女艺术家 👩🏻‍🎨
女藝人	女藝人 👩🏻‍🎨
女藝術家	女藝術家 👩🏻‍🎨
女英雄	女英雄 🦸🏻‍♀
女宇航员	女宇航员 👩🏻‍🚀
女宇航員	女宇航員 👩🏻‍🚀
女仔	女仔 👧 👧🏻 👧🏻
女侦探	女侦探 🕵🏻‍♀
女偵探	女偵探 🕵🏻‍♀
女职员	女职员 👩🏻‍💼
女職員	女職員 👩🏻‍💼
女装	女装 👚
女裝	女裝 👚
女状师	女状师 👩🏻‍⚖
女狀師	女狀師 👩🏻‍⚖
女子	女子 👩 👩🏻 👩🏻
女子体操	女子体操 🤸🏻‍♀
女子體操	女子體操 🤸🏻‍♀
噢	噢 😐 😮
噢噢	噢噢 😀
噢耶	噢耶 ✌ ✌🏻 ✌🏻️
哦	哦 😯 😮 😮
哦哦	哦哦 😀
哦耶	哦耶 ✌ ✌🏻 ✌🏻️
欧	欧 Ω ㏀ ㏁
欧盟	欧盟 🇪🇺
欧姆	欧姆 Ω ㏀ ㏁
欧元	欧元 💶 € 💶
欧圆	欧圆 💶
欧洲	欧洲 🌍
欧洲城堡	欧洲城堡 🏰
欧洲非洲	欧洲非洲 🌍
欧洲邮局	欧洲邮局 🏤
歐盟	歐盟 🇪🇺
歐元	歐元 💶
歐圓	歐圓 💶
歐洲	歐洲 🌍
歐洲城堡	歐洲城堡 🏰
歐洲非洲	歐洲非洲 🌍
歐洲郵局	歐洲郵局 🏤
呕吐	呕吐 🤮
爬泳	爬泳 🏊 🏊🏻‍♀ 🏊🏻‍♂ 🏊🏻
帕	帕 ㎩ ㍱ ㎪ ㎫ ㎬
帕劳	帕劳 🇵🇼
帕勞	帕勞 🇵🇼
帕斯卡	帕斯卡 ㎩ ㍱ ㎪ ㎫ ㎬
怕	怕 😨 😱
拍电影	拍电影 🎬
拍電影	拍電影 🎬
拍摄	拍摄 🎬
拍攝	拍攝 🎬
拍手	拍手 👏 👏🏻 👏🏼 👏🏽 👏🏾 👏🏿 👏🏻
拍戏	拍戏 🎬
拍戲	拍戲 🎬
拍照	拍照 🤳 🤳🏻 🤳🏼 🤳🏽 🤳🏾 🤳🏿 📷
排球	排球 🏐
派	派 🥧
派对	派对 🥳 🎉 🎊
派對	派對 🎉
攀登	攀登 🧗🏻‍♀ 🧗🏻‍♂ 🧗🏻
攀岩	攀岩 🧗‍♂ 🧗‍ 🧗‍♀ 🧗🏻‍♂ 🧗🏼‍♂ 🧗🏽‍♂ 🧗🏾‍♂ 🧗🏿‍♂ 🧗🏻 🧗🏼 🧗🏽 🧗🏾 🧗🏿 🧗🏻‍♀ 🧗🏼‍♀ 🧗🏽‍♀ 🧗🏾‍♀ 🧗🏿‍♀ 🧗🏻
攀巖	攀巖 🧗🏻‍♀ 🧗🏻‍♂ 🧗🏻
盘	盘 💽 💾 💿 📀
盘腿	盘腿 🧘🏻‍♀ 🧘🏻‍♂ 🧘🏻
盤腿	盤腿 🧘🏻‍♀ 🧘🏻‍♂ 🧘🏻
螃蟹	螃蟹 🦀
刨冰	刨冰 🍧
跑	跑 🏃‍♂ 🏃 🏃‍♀ 💨 🏃🏻‍♂ 🏃🏼‍♂ 🏃🏽‍♂ 🏃🏾‍♂ 🏃🏿‍♂ 🏃🏻 🏃🏼 🏃🏽 🏃🏾 🏃🏿 🏃🏻‍♀ 🏃🏼‍♀ 🏃🏽‍♀ 🏃🏾‍♀ 🏃🏿‍♀ 🏃🏻
跑步	跑步 🏃
跑车	跑车 🏎 🏎️
跑車	跑車 🏎 🏎️
跑马	跑马 🐎
跑馬	跑馬 🐎
跑男	跑男 🏃🏻‍♀ 🏃🏻‍♂ 🏃🏻 🏃🏻‍♂️
泡汤	泡汤 ♨
泡湯	泡湯 ♨
泡澡	泡澡 🛀
炮仗	炮仗 🧨
培根	培根 🥓
培养基	培养基 🧫
培养皿	培养皿 🧫
培養基	培養基 🧫
培養皿	培養皿 🧫
喷气	喷气 💨
喷泉	喷泉 ⛲ ⛲️
喷水	喷水 🐳
喷水池	喷水池 ⛲
喷水鲸鱼	喷水鲸鱼 🐳
喷嚏	喷嚏 🤧
喷头	喷头 🚿
噴氣	噴氣 💨
噴泉	噴泉 ⛲ ⛲️
噴水	噴水 🐳
噴水池	噴水池 ⛲
噴水鯨魚	噴水鯨魚 🐳
噴嚏	噴嚏 🤧
噴頭	噴頭 🚿
盆浴	盆浴 🛀 🛁 🛀🏻 🛀🏻 🛁
盆栽	盆栽 🎍 🪴
烹饪	烹饪 🍳
烹飪	烹飪 🍳
朋友	朋友 👬 👭
捧	捧 🤲🏻
椪柑	椪柑 🍊
碰杯	碰杯 🍻 🥂 🥂
碰撞	碰撞 💥
批萨	批萨 🍕
披萨	披萨 🍕
披萨片	披萨片 🍕
披薩	披薩 🍕
披薩片	披薩片 🍕
皮包	皮包 👝
皮特凯恩群岛	皮特凯恩群岛 🇵🇳
皮特凱恩群島	皮特凱恩群島 🇵🇳
皮特肯群岛	皮特肯群岛 🇵🇳
皮特肯群島	皮特肯群島 🇵🇳
皮鞋	皮鞋 👞
疲惫	疲惫 😫
疲憊	疲憊 😫
疲倦	疲倦 😫 😩 🙀
疲劳	疲劳 😪
疲勞	疲勞 😪
啤酒	啤酒 🍺 🍻 🍺
啤酒杯	啤酒杯 🍺 🍻
匹萨饼	匹萨饼 🍕
匹薩餅	匹薩餅 🍕
屁	屁 😛
偏	偏 ∂ 𝛛 𝜕 𝝏
偏旁	偏旁 乛 冫 丷 龹 ⺌ 龸 亻 亼 亽 仒 冖 冂 冃 冄 宀 罒 㓁 罓 冈 凵 厶 刂 勹 匚 匸 卩 阝 厂 丆 广 壬 訁 讠 釒 钅 飠 饣 龺 攵 夂 夊 尢 尣 兂 旡 巜 巛 彐 彑 彡 彳 龰 辶 廴 㞢 忄 㣺 扌 爫 龵 廾 歺 癶 氵 氺 火 灬 爿 丬 疒 牜 ⺶ 犭 豕 豸 虍 艹 卝 龷 丗 龶 芈 丵 菐 黹 礻 衤 糸 糹 纟 龻 镸 髟 襾 覀 吅 㗊 㠭 㸚 叕
片假名	片假名 ア イ ウ エ オ ァ ィ ゥ ェ ォ カ キ ク ケ コ ガ ギ グ ゲ ゴ サ シ ス セ ソ ザ ジ ズ ゼ ゾ タ チ ツ テ ト ダ ヂ ヅ デ ド ッ ナ ニ ヌ ネ ノ ハ ヒ フ ヘ ホ バ ビ ブ ベ ボ パ ピ プ ペ ポ マ ミ ム メ モ ャ ヤ ュ ユ ョ ヨ ラ リ ル レ ロ ワ ヰ ヱ ヲ ン ヴ ヵ ヶ ー ㋐ ㋑ ㋒ ㋓ ㋔ ㋕ ㋖ ㋗ ㋘ ㋙ ㋚ ㋛ ㋜ ㋝ ㋞ ㋟ ㋠ ㋡ ㋢ ㋣ ㋤ ㋥ ㋦ ㋧ ㋨ ㋩ ㋪ ㋫ ㋬ ㋭ ㋮ ㋯ ㋰ ㋱ ㋲ ㋳ ㋴ ㋵ ㋶ ㋷ ㋸ ㋹ ㋺ ㋻ ㋼ ㋽ ㋾ ｱ ｧ ｲ ｨ ｳ ｩ ｴ ｪ ｵ ｫ ｶ ｷ ｸ ｹ ｺ ｻ ｼ ｽ ｾ ｿ ﾀ ﾁ ﾂ ｯ ﾃ ﾄ ﾅ ﾆ ﾇ ﾈ ﾉ ﾊ ﾋ ﾌ ﾍ ﾎ ﾏ ﾐ ﾑ ﾒ ﾓ ﾔ ｬ ﾕ ｭ ﾖ ｮ ﾗ ﾘ ﾙ ﾚ ﾛ ﾜ ｦ ﾝ ･ ﾞ ﾟ
骗你的	骗你的 😜
骗钱	骗钱 💸
骗人	骗人 🤥
骗子	骗子 🤥
騙你的	騙你的 😜
騙錢	騙錢 💸
騙人	騙人 🤥
騙子	騙子 🤥
漂亮	漂亮 😍 😻
飘动	飘动 📜
飘落	飘落 🍃
飘舞	飘舞 🍃
飘扬	飘扬 📜
飄動	飄動 📜
飄落	飄落 🍃
飄舞	飄舞 🍃
飄揚	飄揚 📜
瓢虫	瓢虫 🐞
瓢蟲	瓢蟲 🐞
票	票 🎫
票据	票据 🎫
票據	票據 🎫
撇	撇 丿
撇嘴	撇嘴 😕
拼图	拼图 🧩
拼圖	拼圖 🧩
频率	频率 ㎐ ㎑ ㎒ ㎓ ㎔
嫔妃	嫔妃 👸 👸🏻 👸🏻
嬪妃	嬪妃 👸 👸🏻 👸🏻
聘礼	聘礼 💝
聘禮	聘禮 💝
乒乓	乒乓 🏓
乒乓球	乒乓球 🏓
乒乓球拍	乒乓球拍 🏓
平成	平成 ㍻
平底锅	平底锅 🍳
平底鍋	平底鍋 🍳
平底鞋	平底鞋 🥿
平方米	平方米 ㎡
平行四边形	平行四边形 ⏥
平假名	平假名 あ い う え お ぁ ぃ ぅ ぇ ぉ か き く け こ が ぎ ぐ げ ご さ し す せ そ ざ じ ず ぜ ぞ た ち つ て と だ ぢ づ で ど っ な に ぬ ね の は ひ ふ へ ほ ば び ぶ べ ぼ ぱ ぴ ぷ ぺ ぽ ま み む め も や ゆ よ ゃ ゅ ょ ら り る れ ろ わ を ん ゎ
苹果	苹果 🍎 🍏  🍎 🍏
凭条	凭条 🧾
憑條	憑條 🧾
蘋果	蘋果 🍎 🍏
破财	破财 💸
破財	破財 💸
破产	破产 💸
破產	破產 💸
破壳	破壳 🐣
破壳而出	破壳而出 🐣
破殼	破殼 🐣
破殼而出	破殼而出 🐣
破涕为笑	破涕为笑 😂
破涕為笑	破涕為笑 😂
破玩意	破玩意 😒
破玩意儿	破玩意儿 😒
破玩意兒	破玩意兒 😒
破屋	破屋 🏚 🏚️
破折号	破折号 ——
扑克	扑克 🃏 ♠ ♥ ♦ ♣ ♤ ♡ ♧ ♢ 🃏️
扑克牌	扑克牌 🃏 🎴
撲克	撲克 🃏 🃏️
撲克牌	撲克牌 🃏 🎴
葡国	葡国 🇵🇹
葡國	葡國 🇵🇹
葡萄	葡萄 🍇
葡萄酒	葡萄酒 🍷
葡萄酒杯	葡萄酒杯 🍷
葡萄牙	葡萄牙 🇵🇹
蒲隆地	蒲隆地 🇧🇮
谱曲	谱曲 🎼
譜曲	譜曲 🎼
七	七 七、 柒 Ⅶ 〧 ⁷ ₇ ⓻ 𝟟 ⒎ 🄈 ㊆ ㈦ 7⃣ 𓃏 7️⃣
七点	七点 🕖
七点半	七点半 🕢
七点钟	七点钟 🕖
七點	七點 🕖
七點半	七點半 🕢
七點鐘	七點鐘 🕖
七情	七情 喜 怒 忧 思 悲 恐 惊
七夕	七夕 🎋
七夕节	七夕节 🎋
七夕節	七夕節 🎋
七夕树	七夕树 🎋
七夕樹	七夕樹 🎋
七星瓢虫	七星瓢虫 🐞
七星瓢蟲	七星瓢蟲 🐞
奇异果	奇异果 🥝
奇異果	奇異果 🥝
祈祷	祈祷 🙏 🤲 🙏🏻 🙏🏼 🙏🏽 🙏🏾 🙏🏿 🤲🏻 🤲🏼 🤲🏽 🤲🏾 🤲🏿
祈福	祈福 🙏 🙏🏻 🙏🏼 🙏🏽 🙏🏾 🙏🏿
脐橙	脐橙 🍊
骑车	骑车 🚴‍♂ 🚴 🚴‍♀ 🚵‍♂ 🚵 🚵‍♀ 🚴🏻‍♂ 🚴🏼‍♂ 🚴🏽‍♂ 🚴🏾‍♂ 🚴🏿‍♂ 🚴🏻 🚴🏼 🚴🏽 🚴🏾 🚴🏿 🚴🏻‍♀ 🚴🏼‍♀ 🚴🏽‍♀ 🚴🏾‍♀ 🚴🏿‍♀ 🚵🏻‍♂ 🚵🏼‍♂ 🚵🏽‍♂ 🚵🏾‍♂ 🚵🏿‍♂ 🚵🏻 🚵🏼 🚵🏽 🚵🏾 🚵🏿 🚵🏻‍♀ 🚵🏼‍♀ 🚵🏽‍♀ 🚵🏾‍♀ 🚵🏿‍♀ 🚲 🚲 🚴🏻
骑车登山	骑车登山 🚵
骑单车	骑单车 🚴 🚴🏻‍♀ 🚴🏻‍♂ 🚴🏻
骑行	骑行 🚴 🚴🏻‍♀ 🚴🏻‍♂ 🚴🏻
骑马	骑马 🏇 🏇🏻 🏇🏼 🏇🏽 🏇🏾 🏇🏿 🏇🏻
骑自行车	骑自行车 🚴 🚴🏻‍♀ 🚴🏻‍♂ 🚴🏻
旗	旗 🏁 🚩 🎌 🏴 🏳 🏳‍🌈 🏴‍☠
旗杆	旗杆 🚩
旗桿	旗桿 🚩
旗帜	旗帜 🏁 🚩 🎌 🏴 🏳 🏳‍🌈 🏴‍☠
旗子	旗子 🏁 🚩 🎌 🏴 🏳 🏳‍🌈 🏴‍☠
鮨	鮨 🍣
騎車	騎車 🚲 🚴 🚴🏻‍♀ 🚴🏻‍♂ 🚲 🚴🏻
騎車登山	騎車登山 🚵
騎單車	騎單車 🚴 🚴🏻‍♀ 🚴🏻‍♂ 🚴🏻
騎行	騎行 🚴 🚴🏻‍♀ 🚴🏻‍♂ 🚴🏻
騎馬	騎馬 🏇 🏇🏻 🏇🏻
騎自行車	騎自行車 🚴 🚴🏻‍♀ 🚴🏻‍♂ 🚴🏻
臍橙	臍橙 🍊
麒麟	麒麟 🦄
企	企 ㊭ ㈽ 🧍🏻
企鹅	企鹅 🐧
企鵝	企鵝 🐧
启用	启用 🔛
起飞	起飞 🛫
起飛	起飛 🛫
起火	起火 🔥
起始符	起始符 〽 〽️
起司	起司 🧀
起雾	起雾 🌁
起霧	起霧 🌁
起重机	起重机 🏗
起子	起子 🔧 🔧 🪛
啟用	啟用 🔛
气愤	气愤 💢 😠 😡
气馁	气馁 🙁 🙍 🙁
气球	气球 🎈
气炸	气炸 🤯
汽车	汽车 🚗 🚕 🚙 🚌 🚎 🏎 🚓 🚑 🚒 🚐 🚚 🚛 🚔 🚍 🚘 🚖 🚗 🚕 🚙 🚌 🚎 🏎 🚓 🚑 🚒 🚐 🚚 🚛 🎢 🛻 🚔 🚍 🚘 🚖 🛺
汽車	汽車 🚗 🚕 🚙 🚌 🚎 🏎 🚓 🚑 🚒 🚐 🚚 🚛 🚔 🚍 🚘 🚖 🚗 🚕 🚙 🚌 🚎 🏎 🚓 🚑 🚒 🚐 🚚 🚛 🎢 🛻 🚔 🚍 🚘 🚖 🛺
汽水	汽水 🥤
汽艇	汽艇 🚤 🛥 🛥️
氣憤	氣憤 💢 😠 😡
氣餒	氣餒 🙁 🙍 🙁
氣球	氣球 🎈
器官	器官 👀 👂 👃 👄 👅 👣 👁 👂🏻 👃🏻 👄 🦷 🧠 🫁 🫀 🦵🏻 🦶🏻 🖐🏻 👅
千	千 ㌔ 仟
千分	千分 ‰
千克	千克 ㎏
千里达及托巴哥	千里达及托巴哥 🇹🇹
千里達及托巴哥	千里達及托巴哥 🇹🇹
千米	千米 ㎞
千字文	千字文 天地玄黄 宇宙洪荒 日月盈昃 辰宿列张 寒来暑往 秋收冬藏 闰余成岁 律吕调阳 云腾致雨 露结为霜 金生丽水 玉出昆岗 剑号巨阙 珠称夜光 果珍李柰 菜重芥姜 海咸河淡 鳞潜羽翔 龙师火帝 鸟官人皇 始制文字 乃服衣裳 推位让国 有虞陶唐 吊民伐罪 周发殷汤 坐朝问道 垂拱平章 爱育黎首 臣伏戎羌 遐迩一体 帅宾归王 鸣凤在竹 白驹食场 化被草木 赖及万方 盖此身发 四大五常 恭惟鞠养 岂敢毁伤 女慕贞洁 男效才良 知过必改 得能莫忘 罔谈彼短 靡恃己长 信使可复 器欲难量 墨悲丝染 诗赞羔羊 景行维贤 克念作圣 德建名立 形端表正 空谷传声 虚堂习听 祸因恶积 福缘善庆 尺璧非宝 寸阴是竞 资父事君 曰严与敬 孝当竭力 忠则尽命 临深履薄 夙兴温凊 似兰斯馨 如松之盛 川流不息 渊澄取映 容止若思 言辞安定 笃初诚美 慎终宜令 荣业所基 籍甚无竟 学优登仕 摄职从政 存以甘棠 去而益咏 乐殊贵贱 礼别尊卑 上和下睦 夫唱妇随 外受傅训 入奉母仪 诸姑伯叔 犹子比儿 孔怀兄弟 同气连枝 交友投分 切磨箴规 仁慈隐恻 造次弗离 节义廉退 颠沛匪亏 性静情逸 心动神疲 守真志满 逐物意移 坚持雅操 好爵自縻 都邑华夏 东西二京 背邙面洛 浮渭据泾 宫殿盘郁 楼观飞惊 图写禽兽 画彩仙灵 丙舍旁启 甲帐对楹 肆筵设席 鼓瑟吹笙 升阶纳陛 弁转疑星 右通广内 左达承明 既集坟典 亦聚群英 杜稿钟隶 漆书壁经 府罗将相 路侠槐卿 户封八县 家给千兵 高冠陪辇 驱毂振缨 世禄侈富 车驾肥轻 策功茂实 勒碑刻铭 盘溪伊尹 佐时阿衡 奄宅曲阜 微旦孰营 桓公匡合 济弱扶倾 绮回汉惠 说感武丁 俊乂密勿 多士是宁 晋楚更霸 赵魏困横 假途灭虢 践土会盟 何遵约法 韩弊烦刑 起翦颇牧 用兵最精 宣威沙漠 驰誉丹青 九州禹迹 百郡秦并 岳宗泰岱 禅主云亭 雁门紫塞 鸡田赤城 昆池碣石 钜野洞庭 旷远绵邈 岩岫杳冥 治本于农 务资稼穑 俶载南亩 我艺黍稷 税熟贡新 劝赏黜陟 孟轲敦素 史鱼秉直 庶几中庸 劳谦谨敕 聆音察理 鉴貌辨色 贻厥嘉猷 勉其祗植 省躬讥诫 宠增抗极 殆辱近耻 林皋幸即 两疏见机 解组谁逼 索居闲处 沉默寂寥 求古训论 散虑逍遥 欣奏累遣 戚谢欢招 渠荷的历 园莽抽条 枇杷晚翠 梧桐蚤凋 陈根委翳 落叶飘摇 游鹍独运 凌摩绛霄 耽读玩市 寓目囊箱 易輶攸畏 属耳垣墙 具膳餐饭 适口充肠 饱饫烹宰 饥厌糟糠 亲戚故旧 老少异粮 妾御绩纺 侍巾帷房 纨扇圆洁 银烛炜煌 昼眠夕寐 蓝笋象床 弦歌酒宴 接杯举觞 矫手顿足 悦豫且康 嫡后嗣续 祭祀烝尝 稽颡再拜 悚惧恐慌 笺牒简要 顾答审详 骸垢想浴 执热愿凉 驴骡犊特 骇跃超骧 诛斩贼盗 捕获叛亡 布射僚丸 嵇琴阮啸 恬笔伦纸 钧巧任钓 释纷利俗 并皆佳妙 毛施淑姿 工颦妍笑 年矢每催 曦晖朗曜 旋即斡旋 晦魄环照 指薪修祜 永绥吉劭 矩步引领 俯仰廊庙 束带矜庄 徘徊瞻眺 孤陋寡闻 愚蒙等诮 谓语助者 焉哉乎也
牵手	牵手 👬 👫 👭 👬🏻 👨🏻‍🤝‍👨🏼 👨🏻‍🤝‍👨🏽 👨🏻‍🤝‍👨🏾 👨🏻‍🤝‍👨🏿 👨🏼‍🤝‍👨🏻 👬🏼 👨🏼‍🤝‍👨🏽 👨🏼‍🤝‍👨🏾 👨🏼‍🤝‍👨🏿 👨🏽‍🤝‍👨🏻 👨🏽‍🤝‍👨🏼 👬🏽 👨🏽‍🤝‍👨🏾 👨🏽‍🤝‍👨🏿 👨🏾‍🤝‍👨🏻 👨🏾‍🤝‍👨🏼 👨🏾‍🤝‍👨🏽 👬🏾 👨🏾‍🤝‍👨🏿 👨🏿‍🤝‍👨🏻 👨🏿‍🤝‍👨🏼 👨🏿‍🤝‍👨🏽 👨🏿‍🤝‍👨🏾 👬🏿 👫🏻 👩🏻‍🤝‍👨🏼 👩🏻‍🤝‍👨🏽 👩🏻‍🤝‍👨🏾 👩🏻‍🤝‍👨🏿 👩🏼‍🤝‍👨🏻 👫🏼 👩🏼‍🤝‍👨🏽 👩🏼‍🤝‍👨🏾 👩🏼‍🤝‍👨🏿 👩🏽‍🤝‍👨🏻 👩🏽‍🤝‍👨🏼 👫🏽 👩🏽‍🤝‍👨🏾 👩🏽‍🤝‍👨🏿 👩🏾‍🤝‍👨🏻 👩🏾‍🤝‍👨🏼 👩🏾‍🤝‍👨🏽 👫🏾 👩🏾‍🤝‍👨🏿 👩🏿‍🤝‍👨🏻 👩🏿‍🤝‍👨🏼 👩🏿‍🤝‍👨🏽 👩🏿‍🤝‍👨🏾 👫🏿 👭🏻 👩🏻‍🤝‍👩🏼 👩🏻‍🤝‍👩🏽 👩🏻‍🤝‍👩🏾 👩🏻‍🤝‍👩🏿 👩🏼‍🤝‍👩🏻 👭🏼 👩🏼‍🤝‍👩🏽 👩🏼‍🤝‍👩🏾 👩🏼‍🤝‍👩🏿 👩🏽‍🤝‍👩🏻 👩🏽‍🤝‍👩🏼 👭🏽 👩🏽‍🤝‍👩🏾 👩🏽‍🤝‍👩🏿 👩🏾‍🤝‍👩🏻 👩🏾‍🤝‍👩🏼 👩🏾‍🤝‍👩🏽 👭🏾 👩🏾‍🤝‍👩🏿 👩🏿‍🤝‍👩🏻 👩🏿‍🤝‍👩🏼 👩🏿‍🤝‍👩🏽 👩🏿‍🤝‍👩🏾 👭🏿 🧑🏻‍🤝‍🧑🏻
铅笔	铅笔 ✏ ✏️
牽手	牽手 👫 👬 👭 🧑🏻‍🤝‍🧑🏻
签	签 🏷 🏷️
签语饼	签语饼 🥠
鉛筆	鉛筆 ✏ ✏️
簽語餅	簽語餅 🥠
籤	籤 🏷 🏷️
前	前 🈜 ⬆ ⬆️
钱	钱 💰 💸 💱 💲 💴 💵 💶 💷 ₳ ฿ ₿ ￠ ₡ ¢ ₢ ₵ ₫ € ￡ £ ₤ ₣ ƒ ₲ ₭ Ł ₦ ₱ ＄ $ ₮ ℳ ₩ ￦ ¥ ￥ ₴ ¤ ₰ ៛ ₪ ₯ ₠ ₧ ﷼ 円 元 圓 ㍐ 원 ৳ ₹ ₨ ৲ ௹ 💰 🪙
钱包	钱包 👛 💰 👛
钱包丢了	钱包丢了 💸
钱币	钱币 💲 💲 🪙
钱袋	钱袋 💰 👛 👛 💰
钱丢了	钱丢了 💸
钱飞了	钱飞了 💸
钱夹	钱夹 👛
乾	乾 ☰
乾杯	乾杯 🍻 🥂 🥂
潜水	潜水 🤿
潜水镜	潜水镜 🥽 🤿 🥽
潛水鏡	潛水鏡 🥽 🤿 🥽
錢	錢 💰 💰 🪙
錢包	錢包 👛
錢包丟了	錢包丟了 💸
錢幣	錢幣 💲 💲 🪙
錢袋	錢袋 👛 💰
錢丟了	錢丟了 💸
錢飛了	錢飛了 💸
錢夾	錢夾 👛
枪	枪 🔫
枪械	枪械 🔫
槍	槍 🔫
槍械	槍械 🔫
強壯	強壯 💪
强	强 👍 👍🏻 👍🏼 👍🏽 👍🏾 👍🏿
强壮	强壮 💪 🦾 💪🏻 💪🏼 💪🏽 💪🏾 💪🏿
墙砖	墙砖 🧱
蔷薇	蔷薇 🌹
薔薇	薔薇 🌹
牆磚	牆磚 🧱
悄悄	悄悄 😷
悄悄地	悄悄地 🤫
敲打	敲打 🔨
乔治亚	乔治亚 🇬🇪
桥	桥 🌉
喬治亞	喬治亞 🇬🇪
喬治亞共和國	喬治亞共和國 🇬🇪
瞧	瞧 👀
巧克力	巧克力 🍫
巧克力棒	巧克力棒 🍫
巧克力饼	巧克力饼 🍪
巧克力餅	巧克力餅 🍪
巧克力圈	巧克力圈 🍩
切	切 😏 😝 🤪 🤪
切换输入	切换输入 🔤
切換輸入	切換輸入 🔤
茄	茄 🍆
茄子	茄子 🍆
亲	亲 😗 😙 😚 😽 💏 👨‍❤‍💋‍👨 👩‍❤‍💋‍👩 😘 😘
亲爱	亲爱 😚
亲昵	亲昵 😽
亲亲	亲亲 💋 😘 😚 😽
亲吻	亲吻 💏 👨‍❤‍💋‍👨 👩‍❤‍💋‍👩 😚 💏
亲一个	亲一个 😙 😽
亲一口	亲一口 💋 😚 😽
亲嘴	亲嘴 💏 👨‍❤‍💋‍👨 👩‍❤‍💋‍👩 💋 😙 😽 💏 😙 😽
琴键	琴键 🎹
琴鍵	琴鍵 🎹
琴谱	琴谱 🎼
琴譜	琴譜 🎼
禽	禽 🦆 🐓 🦃 🐔 🐤 🐣 🐥 🦚
青菜	青菜 🥬
青虫	青虫 🐛
青蟲	青蟲 🐛
青筋	青筋 💢
青龙	青龙 🐉
青龍	青龍 🐉
青苗	青苗 🌱
青苹果	青苹果 🍏
青蘋果	青蘋果 🍏
青蛙	青蛙 🐸 𓆏 🐸
青蛙脸	青蛙脸 🐸
青蛙臉	青蛙臉 🐸
青心	青心 💙
轻点	轻点 🤫
轻轨	轻轨 🚈 🚊 🚝 🚞 🚋 Ⓜ Ⓜ️ 🚈
轻轨电车	轻轨电车 🚈
轻松	轻松 😉
氢弹	氢弹 ☢ ☢️
氫彈	氫彈 ☢ ☢️
清晨	清晨 🌄
清除	清除 🆑 🆑️
清酒	清酒 🍶
清空	清空 🆑 🆑️
清凉	清凉 🆒
清涼	清涼 🆒
清零	清零 🆑
清零键	清零键 🆑
清零鍵	清零鍵 🆑
清洗	清洗 🧴
清真寺	清真寺 🕌
輕點	輕點 🤫
輕軌	輕軌 Ⓜ 🚈 Ⓜ️ 🚈
輕軌電車	輕軌電車 🚈
輕鬆	輕鬆 😉
情报	情报 🔎
情報	情報 🔎
情侣	情侣 👫 👬 👭 💑 👨‍❤‍👨 👩‍❤‍👩
情侣酒店	情侣酒店 🏩
情侶	情侶 👫 💑
情侶酒店	情侶酒店 🏩
情人酒店	情人酒店 🏩
情书	情书 💌
情書	情書 💌
晴	晴 ☀ ☀️
晴间多云	晴间多云 ⛅
晴間多雲	晴間多雲 ⛅
晴空	晴空 ☀ ☀️
晴朗	晴朗 ☀ ☀️
晴时多云	晴时多云 🌤 🌤️
晴時多雲	晴時多雲 🌤 🌤️
晴天	晴天 ☀
请	请 💁🏻‍♀ 💁🏻‍♂ 💁🏻
请勿乱扔	请勿乱扔 🚯
請	請 💁🏻‍♀ 💁🏻‍♂ 💁🏻
請勿亂扔	請勿亂扔 🚯
庆典	庆典 🎈 🎉 🎊 🎊
庆祝	庆祝 🍾 🥳 ❇ ㊗ 🍻 🎀 🎁 🎂 🎃 🎄 🎅 🎆 🎇 🎈 🎉 🎊 🎋 🎎 🎏 🎐 🎑 🎓 🏮 🙌 🙌🏻 🍻 🙌🏻 🥳
慶典	慶典 🎈 🎉 🎊 🎊
慶祝	慶祝 ❇ ㊗ 🍻 🎀 🎁 🎂 🎃 🎄 🎅 🎆 🎇 🎈 🎉 🎊 🎋 🎎 🎏 🎐 🎑 🎓 🏮 🙌 🙌🏻 🥳 🍻 🙌🏻 🥳
親	親 😘
親愛	親愛 😚
親暱	親暱 😽
親親	親親 💋 😘 😚 😽
親吻	親吻 👨‍❤‍💋‍👨 👩‍❤‍💋‍👩 💏 😚 💏
親一個	親一個 😙 😽
親一口	親一口 💋 😚 😽
親嘴	親嘴 💋 💏 😙 😽 💏 😙 😽
邱比特	邱比特 💘
秋	秋 🀨
䲡鱼	䲡鱼 🦑
求	求 🥺
求和	求和 ∑
求救	求救 🆘 🆘️
求求你	求求你 🥺
球	球 ⚽ 🏀 🏈 🏐 🏉 🥎 🎾 🎱 🏓 🏸 🏒 🏑 🏏 🛹 🥍 ⚽ 🏀 🏈 🏐 🏉 ⚾️ 🥎 🎾 🎱 🪀 🏓 🏸 🏒 🏑 🏏 🛹 🥍
球洞	球洞 🕳 🕳️
球杆	球杆 🏑 🏒
球桿	球桿 🏑 🏒
球门	球门 🥅
球門	球門 🥅
球拍	球拍 🏓 🏸
球鞋	球鞋 👟
趋势	趋势 📈 📉 📊
蛐蛐	蛐蛐 🦗
曲別針	曲別針 🧷
曲别针	曲别针 📎 🖇 🧷 🧷
曲棍球	曲棍球 🏑 🏒 🥍 🏑 🏒
曲棍网球	曲棍网球 🥍
曲棍網球	曲棍網球 🥍
曲谱	曲谱 🎼
曲譜	曲譜 🎼
曲奇	曲奇 🍪
取款	取款 🏧
取款机	取款机 🏧
取款機	取款機 🏧
取钱	取钱 🏧
取錢	取錢 🏧
去氧核糖核酸	去氧核糖核酸 🧬
麮𪌽	麮𪌽 🥖
圈圈	圈圈 ⭕ ⭕️
全等	全等 ≅
全家	全家 👨‍👩‍👦 👨‍👩‍👦‍👦 👨‍👩‍👧 👨‍👩‍👧‍👦 👨‍👩‍👧‍👧
拳	拳 ✊ 👊 🤛 🤜 ✊🏻 ✊🏼 ✊🏽 ✊🏾 ✊🏿 👊🏻 👊🏼 👊🏽 👊🏾 👊🏿 🤛🏻 🤛🏼 🤛🏽 🤛🏾 🤛🏿 🤜🏻 🤜🏼 🤜🏽 🤜🏾 🤜🏿 👊🏻
拳击	拳击 🥊
拳擊	拳擊 🥊
拳套	拳套 🥊
拳头	拳头 ✊ 👊 👊🏻 👊🏻
拳头手势	拳头手势 👊
拳頭	拳頭 ✊ 👊 👊🏻 👊🏻
拳頭手勢	拳頭手勢 👊
犬	犬 🐕
缺心眼	缺心眼 🤪
缺月	缺月 🌖
确定	确定 ✅ ☑
确认	确认 ✅
确认手势	确认手势 👌
確定	確定 ☑ ✅
確認手勢	確認手勢 👌
裙	裙 👗
裙子	裙子 👗 👚 👗
羣花	羣花 🌼
群岛	群岛 🗾
群島	群島 🗾
群花	群花 🌼
燃料	燃料 ⛽
燃料泵	燃料泵 ⛽
燃烧	燃烧 🔥
燃燒	燃燒 🔥
让利	让利 🈹
让人失望	让人失望 ☹ ☹️
讓利	讓利 🈹
讓人失望	讓人失望 ☹ ☹️
热	热 🥵 ☀ 🔥 ☀️ 🔥 🥵 🫠
热爱	热爱 😻
热茶	热茶 🍵
热带饮品	热带饮品 🍹
热带鱼	热带鱼 🐠
热狗	热狗 🌭
热恋中	热恋中 💑 💑🏻
热气腾腾	热气腾腾 🍲
热情	热情 ❤ ❤️‍🔥
热水	热水 ♨
热汤	热汤 ♨
热饮	热饮 ☕ 🍵 ☕️ 🍵
熱	熱 ☀ 🔥 🥵 ☀️ 🔥 🥵 🫠
熱愛	熱愛 😻
熱茶	熱茶 🍵
熱帶飲品	熱帶飲品 🍹
熱帶魚	熱帶魚 🐠
熱狗	熱狗 🌭
熱戀中	熱戀中 💑 💑🏻
熱氣騰騰	熱氣騰騰 🍲
熱情	熱情 ❤ ❤️‍🔥
熱水	熱水 ♨
熱湯	熱湯 ♨
熱飲	熱飲 ☕ 🍵 ☕️ 🍵
人	人 🧍 🧍‍♂ 🧍‍♀ 🧍🏻‍♂ 🧍🏼‍♂ 🧍🏽‍♂ 🧍🏾‍♂ 🧍🏿‍♂ 🧍🏻‍♀ 🧍🏼‍♀ 🧍🏽‍♀ 🧍🏾‍♀ 🧍🏿‍♀ 🧍🏻 🧍🏼 🧍🏽 🧍🏾 🧍🏿
人工智能	人工智能 🤖
人民币	人民币 ￥ 💴 💴
人民幣	人民幣 💴
人鱼	人鱼 🧜🏻‍♀ 🧜🏻‍♂ 🧜🏻
人魚	人魚 🧜🏻‍♀ 🧜🏻‍♂ 🧜🏻
人造卫星	人造卫星 🛰 🛰️
人造衛星	人造衛星 🛰 🛰️
认不得	认不得 😲 🤷🏻‍♀ 🤷🏻‍♂ 😲 🤷🏻
认真	认真 🧐
任意	任意 ∀
妊娠	妊娠 🤰🏻 🫄🏻
認不得	認不得 😲 🤷🏻‍♀ 🤷🏻‍♂ 😲 🤷🏻
認真	認真 🧐
日	日 ㊐ ㈰ ㏠ ㏡ ㏢ ㏣ ㏤ ㏥ ㏦ ㏧ ㏨ ㏩ ㏪ ㏫ ㏬ ㏭ ㏮ ㏯ ㏰ ㏱ ㏲ ㏳ ㏴ ㏵ ㏶ ㏷ ㏸ ㏹ ㏺ ㏻ ㏼ ㏽ ㏾ 🌞 🌞
日本	日本 🇯🇵 🗾 🎌 ㍻ ㍼ ㍽ ㍾ ㍿ 🇯🇵
日本菜	日本菜 🍥 🍣 🍱 🍙 🍘
日本城堡	日本城堡 🏯
日本国	日本国 🇯🇵
日本国旗	日本国旗 🇯🇵
日本國	日本國 🇯🇵
日本國旗	日本國旗 🇯🇵
日本男儿节	日本男儿节 🎏
日本男兒節	日本男兒節 🎏
日本女儿节	日本女儿节 🎎
日本女兒節	日本女兒節 🎎
日本娃娃	日本娃娃 🎎
日本新年	日本新年 🎍
日本邮局	日本邮局 🏣
日本郵局	日本郵局 🏣
日出	日出 🌄 🌅 🌄
日耳曼战车	日耳曼战车 🇩🇪
日耳曼戰車	日耳曼戰車 🇩🇪
日光	日光 🌞
日火	日火 👿
日历	日历 📅 📆 🗓 📅
日曆	日曆 📅 📆 📅
日料	日料 🍥 🍣 🍱 🍙 🍘
日落	日落 🌆 🌇 🌇
日暮	日暮 🌇
日期	日期 📅
日式服装	日式服装 👘
日式服裝	日式服裝 👘
日式料理	日式料理 🍥 🍣 🍱 🍙 🍘
日式人偶	日式人偶 🎎
日用	日用 🧴 🧼 🧻 🧽 💄 🧴 🧼 🧻 🧽 🪥 🪒 💄 🪣
日语	日语 ㌀ ㌁ ㌂ ㌃ ㌄ ㌅ ㌆ ㌇ ㌈ ㌉ ㌊ ㌋ ㌌ ㌍ ㌎ ㌏ ㌐ ㌑ ㌒ ㌓ ㌔ ㌕ ㌖ ㌗ ㌘ ㌙ ㌚ ㌛ ㌜ ㌝ ㌞ ㌟ ㌠ ㌡ ㌢ ㌣ ㌤ ㌥ ㌦ ㌧ ㌨ ㌩ ㌪ ㌫ ㌬ ㌭ ㌮ ㌯ ㌰ ㌱ ㌲ ㌳ ㌴ ㌵ ㌶ ㌷ ㌸ ㌹ ㌺ ㌻ ㌼ ㌽ ㌾ ㌿ ㍀ ㍁ ㍂ ㍃ ㍄ ㍅ ㍆ ㍇ ㍈ ㍉ ㍊ ㍋ ㍌ ㍍ ㍎ ㍏ ㍐ ㍑ ㍒ ㍓ ㍔ ㍕ ㍖ ㍗
日元	日元 💴 円
日円	日円 💴
日圆	日圆 💴
日圓	日圓 💴
日章旗	日章旗 🇯🇵
容量	容量 ㎕ ㎖ ㎗ ㎘
溶剂	溶剂 🧪
溶劑	溶劑 🧪
溶液	溶液 🧪
柔道	柔道 🥋 🤼 🤼‍♂ 🤼🏻
肉	肉 🍖 🍗 🥩 🥓 🍤 🥩 🥓 🍗 🍖 🍤
肉串	肉串 🍢 🍖
肉骨	肉骨 🍖
肉卷	肉卷 🥓
肉捲	肉捲 🥓
肉丸	肉丸 🍡
如厕	如厕 🚾
如廁	如廁 🚾
乳	乳 🥛
乳酪	乳酪 🧀
乳牛	乳牛 🐄
乳液	乳液 🧴
入場券	入場券 🎟 🎫 🎟️
入场券	入场券 🎟 🎫 🎟️
软碟	软碟 💾
软盘	软盘 💾
軟碟	軟碟 💾
軟盤	軟盤 💾
瑞典	瑞典 🇸🇪
瑞士	瑞士 🇨🇭
弱	弱 👎 👎🏻 👎🏼 👎🏽 👎🏾 👎🏿
洒水	洒水 💦
撒哈拉	撒哈拉 🇪🇭
撒拉威阿拉伯	撒拉威阿拉伯 🇪🇭
灑水	灑水 💦
萨巴	萨巴 🇧🇶
萨尔瓦多	萨尔瓦多 🇸🇻
萨尔瓦多共和国	萨尔瓦多共和国 🇸🇻
萨克斯	萨克斯 🎷
萨克斯风	萨克斯风 🎷
萨摩亚	萨摩亚 🇼🇸
萨摩亚群岛	萨摩亚群岛 🇼🇸
薩巴	薩巴 🇧🇶
薩爾瓦多	薩爾瓦多 🇸🇻
薩爾瓦多共和國	薩爾瓦多共和國 🇸🇻
薩克斯	薩克斯 🎷
薩克斯風	薩克斯風 🎷
薩摩亞	薩摩亞 🇼🇸
薩摩亞群島	薩摩亞群島 🇼🇸
塞尔维亚	塞尔维亚 🇷🇸
塞爾維亞	塞爾維亞 🇷🇸
塞拉利昂	塞拉利昂 🇸🇱
塞內加爾	塞內加爾 🇸🇳
塞内加尔	塞内加尔 🇸🇳
塞内加爾	塞内加爾 🇸🇳
塞浦路斯	塞浦路斯 🇨🇾
塞舌尔	塞舌尔 🇸🇨
塞舌爾	塞舌爾 🇸🇨
塞席尔	塞席尔 🇸🇨
塞席爾	塞席爾 🇸🇨
塞著	塞著 😧
赛车	赛车 🏎 🏁 🏎️
赛车比赛	赛车比赛 🏁
赛马	赛马 🏇 🏇🏻 🏇🏼 🏇🏽 🏇🏾 🏇🏿 🏇🏻
赛跑	赛跑 🏃
赛普勒斯	赛普勒斯 🇨🇾
赛艇	赛艇 🚣 🚤 🚣🏻‍♀ 🚣🏻‍♂ 🚣🏻 🚤
賽車	賽車 🏁 🏎 🏎️
賽車比賽	賽車比賽 🏁
賽馬	賽馬 🏇 🏇🏻 🏇🏻
賽跑	賽跑 🏃
賽普勒斯	賽普勒斯 🇨🇾
賽艇	賽艇 🚣 🚤 🚣🏻‍♀ 🚣🏻‍♂ 🚣🏻 🚤
三	三 三、 叁 Ⅲ 〣 ³ ₃ 🈪 ⓷ 𝟛 ⒊ 🄄 ㊂ ㈢ 🉁 3⃣ 𓃋 3️⃣
三叉戟	三叉戟 🔱
三点	三点 🕒
三点半	三点半 🕞
三点钟	三点钟 🕒
三点装	三点装 👙
三點	三點 🕒
三點半	三點半 🕞
三點鐘	三點鐘 🕒
三點裝	三點裝 👙
三戟叉	三戟叉 🔱
三角	三角 🔺 🔻 ▶ ◀ ▸ ◂
三角尺	三角尺 📐
三角旗	三角旗 🚩
三明治	三明治 🥪 🧆 🥙
三十	三十 卅 〺
三文治	三文治 🥙 🥪
三叶草	三叶草 ☘
三葉草	三葉草 ☘
三字经	三字经 人之初 性本善 性相近 习相远 苟不教 性乃迁 教之道 贵以专 昔孟母 择邻处 子不学 断机杼 窦燕山 有义方 教五子 名俱扬 养不教 父之过 教不严 师之惰 非所宜 幼不学 老何为 玉不琢 不成器 人不学 不知义 为人子 方少时 亲师友 习礼仪 香九龄 能温席 孝于亲 所当执 融四岁 能让梨 弟于长 宜先知 首孝弟 次见闻 知某数 识某文 一而十 十而百 百而千 千而万 三才者 天地人 三光者 日月星 三纲者 君臣义 父子亲 夫妇顺 曰春夏 曰秋冬 此四时 运不穷 曰南北 曰西东 此四方 应乎中 曰水火 木金土 此五行 本乎数 曰仁义 礼智信 此五常 不容紊 稻粱菽 麦黍稷 此六谷 人所食 马牛羊 鸡犬豕 此六畜 人所饲 曰喜怒 曰哀惧 爱恶欲 七情具 匏土革 木石金 丝与竹 乃八音 高曾祖 父而身 身而子 子而孙 自子孙 至玄曾 乃九族 人之伦 父子恩 夫妇从 兄则友 弟则恭 长幼序 友与朋 君则敬 臣则忠 此十义 人所同 凡训蒙 须讲究 详训诂 明句读 为学者 必有初 小学终 至四书 论语者 二十篇 群弟子 记善言 孟子者 七篇止 讲道德 说仁义 作中庸 子思笔 中不偏 庸不易 作大学 乃曾子 自脩齐 至平治 孝经通 四书熟 如六经 始可读 诗书易 礼春秋 号六经 当讲求 有连山 有归藏 有周易 三易详 有典谟 有训诰 有誓命 书之奥 我周公 作周礼 著六官 存治体 大小戴 注礼记 述圣言 礼乐备 曰国风 曰雅颂 号四诗 当讽咏 诗既亡 春秋作 寓褒贬 别善恶 三传者 有公羊 有左氏 有谷梁 经既明 方读子 撮其要 记其事 五子者 有荀杨 文中子 及老庄 经子通 读诸史 考世系 知终始 自羲农 至黄帝 号三皇 居上世 唐有虞 号二帝 相揖逊 称盛世 夏有禹 商有汤 周文武 称三王 夏传子 家天下 四百载 迁夏社 汤伐夏 国号商 六百载 至纣亡 周武王 始诛纣 八百载 最长久 周辙东 王纲坠 逞干戈 尚游说 始春秋 终战国 五霸强 七雄出 嬴秦氏 始兼并 传二世 楚汉争 高祖兴 汉业建 至孝平 王莽篡 光武兴 为东汉 四百年 终于献 魏蜀吴 争汉鼎 号三国 迄两晋 宋齐继 梁陈承 为南朝 都金陵 北元魏 分东西 宇文周 与高齐 迨至隋 一土宇 不再传 失统绪 唐高祖 起义师 除隋乱 创国基 二十传 三百载 梁灭之 国乃改 梁唐晋 及汉周 称五代 皆有由 炎宋兴 受周禅 十八传 南北混 十七史 全在兹 载治乱 知兴衰 读史者 考实录 通古今 若亲目 口而诵 心而惟 朝于斯 夕于斯 昔仲尼 师项橐 古圣贤 尚勤学 赵中令 读鲁论 彼既仕 学且勤 披蒲编 削竹简 彼无书 且知勉 头悬梁 锥刺股 彼不教 自勤苦 如囊萤 如映雪 家虽贫 学不辍 如负薪 如挂角 身虽劳 犹苦卓 蘇老泉 二十七 始发愤 读书籍 彼既老 犹悔迟 尔小生 宜早思 若梁灝 八十二 对大廷 魁多士 彼既成 众称异 宜立志 莹八岁 能咏诗 泌七岁 能赋碁 彼颖悟 人称奇 尔幼学 当效之 蔡文姬 能辨琴 谢道韫 能咏吟 彼女子 且聪敏 尔男子 当自警 唐刘晏 方七岁 举神童 作正字 彼虽幼 身己仕 勉而致 有为者 亦若是 犬守夜 鸡司晨 苟不学 曷为人 蚕吐丝 蜂酿蜜 不如物 幼而学 壮而行 上致君 下泽民 扬名声 显父母 光于前 裕于後 人遗子 金满籯 我教子 惟一经 勤有功 戏无益 戒之哉 宜勉力
伞	伞 ⛱ 🌂 ☂ ☔ 🏖
傘	傘 🌂
散度	散度 ∇· div divergence
桑巴舞者	桑巴舞者 🇧🇷
桑拿	桑拿 🧖‍♀ 🧖 🧖‍♂ 🧖🏻‍♂ 🧖🏼‍♂ 🧖🏽‍♂ 🧖🏾‍♂ 🧖🏿‍♂ 🧖🏻 🧖🏼 🧖🏽 🧖🏾 🧖🏿 🧖🏻‍♀ 🧖🏼‍♀ 🧖🏽‍♀ 🧖🏾‍♀ 🧖🏿‍♀
扫帚	扫帚 🧹
掃帚	掃帚 🧹
色拉	色拉 🥗
色子	色子 🎲 ⚀ ⚁ ⚂ ⚃ ⚄ ⚅ 🎲
森巴舞者	森巴舞者 🇧🇷
森林	森林 🌲
沙冰	沙冰 🍧
沙发	沙发 🛋 🛋️
沙發	沙發 🛋 🛋️
沙拉	沙拉 🥗
沙漏	沙漏 ⌛ ⏳ ⌛️
沙漠	沙漠 🏜 🌵 🌵 🏜️
沙滩	沙滩 🏖
沙滩伞	沙滩伞 ⛱
沙滩阳伞	沙滩阳伞 ⛱
沙灘	沙灘 🏖
沙灘傘	沙灘傘 ⛱
沙灘陽傘	沙灘陽傘 ⛱
沙特阿拉伯	沙特阿拉伯 🇸🇦
沙乌地阿拉伯	沙乌地阿拉伯 🇸🇦
沙烏地阿拉伯	沙烏地阿拉伯 🇸🇦
沙中之国	沙中之国 🇳🇪
沙中之國	沙中之國 🇳🇪
砂锅	砂锅 🥘
砂鍋	砂鍋 🥘
砂漏	砂漏 ⌛ ⌛️
莎丽	莎丽 🥻
鲨	鲨 🦈
鲨鱼	鲨鱼 🦈
鯊	鯊 🦈
鯊魚	鯊魚 🦈
啥啊	啥啊 😲
啥也沒說	啥也沒說 🙊
啥也没说	啥也没说 🙊
傻	傻 🤪 🐷 🐷
傻屄	傻屄 🐷
傻逼	傻逼 🐷
傻冒	傻冒 🐷
傻笑	傻笑 😏 😆
山	山 🏔 ⛰ 🌋 🗻 ⛰️
山地车	山地车 🚴 🚵 🚵🏻‍♀ 🚵🏻‍♂ 🚵🏻
山地車	山地車 🚴 🚵 🚵🏻‍♀ 🚵🏻‍♂ 🚵🏻
山地单车	山地单车 🚵 🚵🏻‍♀ 🚵🏻‍♂ 🚵🏻
山地單車	山地單車 🚵 🚵🏻‍♀ 🚵🏻‍♂ 🚵🏻
山地骑行	山地骑行 🚵 🚵🏻‍♀ 🚵🏻‍♂ 🚵🏻
山地騎行	山地騎行 🚵 🚵🏻‍♀ 🚵🏻‍♂ 🚵🏻
山地自行车	山地自行车 🚵 🚵🏻‍♀ 🚵🏻‍♂ 🚵🏻
山地自行車	山地自行車 🚵 🚵🏻‍♀ 🚵🏻‍♂ 🚵🏻
山顶缆车	山顶缆车 🚠
山頂纜車	山頂纜車 🚠
山峰	山峰 ⛰ ⛰️
山轨	山轨 🚞
山軌	山軌 🚞
山间日出	山间日出 🌄
山間日出	山間日出 🌄
山岭	山岭 ⛰ ⛰️
山嶺	山嶺 ⛰ ⛰️
山脉	山脉 ⛰ ⛰️
山脈	山脈 ⛰ ⛰️
山姆大叔	山姆大叔 🇺🇸
山水	山水 🏞 🏞️
山羊	山羊 🐐
删除	删除 🆑 ⌫ ⌦
闪电	闪电 ⚡ 🌩 🌩️
闪光灯	闪光灯 📸
闪亮	闪亮 ✨
闪亮的心	闪亮的心 💖
闪亮之心	闪亮之心 💖
闪闪发光	闪闪发光 🌟
闪烁	闪烁 ✨
閃電	閃電 ⚡ 🌩 🌩️
閃光燈	閃光燈 📸
閃亮	閃亮 ✨
閃亮的心	閃亮的心 💖
閃亮之心	閃亮之心 💖
閃喨的心	閃喨的心 💖
閃閃發光	閃閃發光 🌟
閃爍	閃爍 ✨
扇贝	扇贝 🐚
扇貝	扇貝 🐚
伤	伤 🤕
伤了	伤了 🤕
伤心	伤心 😥 😔 😫 😩 ☹ 💔 😣 😿 ❤️‍🩹
商标	商标 ™ ℠ ® ™️
商標	商標 ™ ™️
商場	商場 🏬
商场	商场 🏬
商店	商店 🏪 🏬
商贩	商贩 👲 👲🏻 👲🏻
商販	商販 👲 👲🏻 👲🏻
商务	商务 ☎ ✉ 💱 💼 📁 📂 📃 📄 📅 📆 📇 📈 📉 📊 📋 📌 📍 📎 📏 📐 📑 📒 📓 📔 📕 📖 📗 📘 📙 📚 📛 📜 📞 📟 📤 📥 📧 📨 📪 📬 📭 🔃
商務	商務 ☎ ✉ 💱 💼 📁 📂 📃 📄 📅 📆 📇 📈 📉 📊 📋 📌 📍 📎 📏 📐 📑 📒 📓 📔 📕 📖 📗 📘 📙 📚 📛 📜 📞 📟 📤 📥 📧 📨 📪 📬 📭 🔃
傷	傷 🤕
傷了	傷了 🤕
傷心	傷心 💔 😣 😩 😿 ❤️‍🩹
上	上 ㊤ ⬆ ↑ ⇑ ⇧ ⇡ ⇈ ⬆️
上班	上班 💼
上班族	上班族 👨‍💼 🧑‍💼 👩‍💼 👨🏻‍💼 👨🏼‍💼 👨🏽‍💼 👨🏾‍💼 👨🏿‍💼 🧑🏻‍💼 🧑🏼‍💼 🧑🏽‍💼 🧑🏾‍💼 🧑🏿‍💼 👩🏻‍💼 👩🏼‍💼 👩🏽‍💼 👩🏾‍💼 👩🏿‍💼
上边	上边 👆 👆🏻 👆🏻
上邊	上邊 👆 👆🏻 👆🏻
上标	上标 ⁰ ¹ ² ³ ⁴ ⁵ ⁶ ⁷ ⁸ ⁹ ˜ ⁺ ⁻ ⁼ ⁽ ⁾ ᴬ ᵄ ᵅ ᶛ ᴭ ᴮ ᴯ ᵝ ᶜ ᵓ ᶝ ᴰ ᶞ ᵟ ᴱ ᴲ ᵊ ᵋ ᶟ ᵌ ᶠ ᶡ ᶲ ᵠ ᴳ ᶢ ˠ ᵞ ᴴ ᶣ ʱ ᴵ ⁱ ᶤ ᵎ ᶥ ᴶ ᶨ ᴷ ᴸ ᶫ ᶩ ᶪ ᴹ ᶬ ᵚ ᶭ ᴺ ᴻ ⁿ ᵑ ᶮ ᶯ ᴼ ᶱ ᴽ ᴾ ᴿ ʶ ʴ ʵ ˢ ᶴ ᶳ ᵀ ᶵ ᶿ ᵁ ᶶ ᶷ ᵙ ⱽ ᶺ ᶹ ᵂ ˣ ᵡ ʸ ᶻ ᶾ ᶽ ᶼ
上厕所	上厕所 🚾
上廁所	上廁所 🚾
上传	上传 ⏫
上傳	上傳 ⏫
上方	上方 🔝
上课	上课 👨🏻‍🏫 👩🏻‍🏫 🧑🏻‍🏫
上課	上課 👨🏻‍🏫 👩🏻‍🏫 🧑🏻‍🏫
上面	上面 👆 👆🏻 👆🏻
上色	上色 🎨
上锁	上锁 🔒
上鎖	上鎖 🔒
上头	上头 👆 👆🏻 👆🏻
上頭	上頭 👆 👆🏻 👆🏻
上午	上午 ㏂
上下	上下 ↕
上下颠倒	上下颠倒 🙃
上下顛倒	上下顛倒 🙃
上下箭头	上下箭头 ↕
上下箭頭	上下箭頭 ↕
上弦月	上弦月 🌓 🌛
上学	上学 🎒
上學	上學 🎒
上一个	上一个 ◀
上一個	上一個 ◀
上一首	上一首 ⏮ ⏮️
上衣	上衣 👕 👚
尚比亚	尚比亚 🇿🇲
尚比亞	尚比亞 🇿🇲
烧火	烧火 🔥
烧瓶	烧瓶 ⚗ ⚗️
烧著	烧著 🔥
蛸	蛸 🐙
燒火	燒火 🔥
燒瓶	燒瓶 ⚗ ⚗️
燒著	燒著 🔥
勺	勺 🥄
勺子	勺子 🥄
少	少 🤏 🤏🏻 🤏🏼 🤏🏽 🤏🏾 🤏🏿
少儿不宜	少儿不宜 🔞
少兒不宜	少兒不宜 🔞
舌	舌 👅
舌头	舌头 👅
舌頭	舌頭 👅
蛇	蛇 🐍 𓆑 𓆓 𓆕 𓆗 𓆙 𓆚 🐍
蛇夫座	蛇夫座 ⛎
蛇年	蛇年 🐍
蛇头	蛇头 🐍
蛇頭	蛇頭 🐍
蛇杖	蛇杖 ⚕ ⚕️
社	社 ㊓ ㈳
社会主义核心价值观	社会主义核心价值观 富强、民主、文明、和谐、自由、平等、公正、法治、爱国、敬业、诚信、友善 富强 民主 文明 和谐 自由 平等 公正 法治 爱国 敬业 诚信 友善
射箭	射箭 🏹
射手座	射手座 ♐ ♐️
摄氏度	摄氏度 ℃
摄像	摄像 🎦 📹 🎦
摄像机	摄像机 📹
摄影	摄影 📹
摄影机	摄影机 🎥 📹 📹
攝像	攝像 🎦 📹 🎦
攝像機	攝像機 📹
攝影	攝影 📹
攝影機	攝影機 🎥 📹 📹
申	申 🈸 🈸️
申请	申请 🈸
申請	申請 🈸
身分	身分 🆔
身分证	身分证 🆔 🆔️ 🪪
身分證	身分證 🆔 🆔️ 🪪
身份	身份 🆔
身体乳	身体乳 🧴
身體乳	身體乳 🧴
身孕	身孕 🤰🏻 🫄🏻
绅士	绅士 🤵🏻 🤵🏻‍♂️
深夜	深夜 🌃
紳士	紳士 🤵🏻 🤵🏻‍♂️
什么	什么 🥴 🤔 😕 😖 😟
神马	神马 🐎 🐴
神馬	神馬 🐎 🐴
神庙	神庙 🏛 🏛️
神廟	神廟 🏛 🏛️
神社	神社 ⛩ ⛩️
神探	神探 🕵 🕵🏻‍♀ 🕵🏻‍♂ 🕵🏻
沈睡	沈睡 💤
沈思	沈思 😔
甚么	甚么 😟
甚麼	甚麼 😟
慎听	慎听 🙉
慎聽	慎聽 🙉
升	升 ㎕ ㎖ ㎗ ㎘ ㍑
升级	升级 🆙
生	生 🈢
生病	生病 😷 🤒 🤕 🤧 🤒
生蚝	生蚝 🦪
生化	生化 ☣ ☣️
生化品	生化品 ☣ ☣️
生化武器	生化武器 ☣ ☣️
生化物质	生化物质 ☣ ☣️
生化物質	生化物質 ☣ ☣️
生气	生气 😤 😡 😠 🤯 💢 🤬 👿 😾 🙎‍♂ 🙎 🙎‍♀ 🙎🏻‍♂ 🙎🏼‍♂ 🙎🏽‍♂ 🙎🏾‍♂ 🙎🏿‍♂ 🙎🏻 🙎🏼 🙎🏽 🙎🏾 🙎🏿 🙎🏻‍♀ 🙎🏼‍♀ 🙎🏽‍♀ 🙎🏾‍♀ 🙎🏿‍♀ 👿 💢 😤 😾
生氣	生氣 😾 😤 😠 😡 👿 💢 👿 💢 😤 😾
生日	生日 🎂
生日蛋糕	生日蛋糕 🎂
生肖	生肖 🐭 🐮 🐯 🐰 🐲 🐍 🐴 🐏 🐵 🐔 🐶 🐷 🐁 🐀 🐂 🐃 🐄 🐅 🐆 🐇 🐈 🐉 🐊 🐋 🐌 🐎 🐐 🐑 🐒 🦃 🐓 🐕 🐖 🐗 🐘 🐁 🐀 🐂 🐃 🐄 🦬 🐅 🐆 🐇 🐉 🐍 🐎 🐏 🐐 🐑 🐒 🦧 🦍 🦃 🐓 🐕 🦮 🐕‍🦺 🐖 🐗
声	声 🈤
声调	声调 ˉ ˊ ˇ ˋ ˆ ˙ ˜ ˥ ˦ ˧ ˨ ˩ ꜀ ꜁ ꜂ ꜃ ꜄ ꜅ ꜆ ꜇
声音	声音 🔇 🔈 🔉 🔊
牲畜	牲畜 🐄 🐃 🐂 🐐 🐏 🐖 🐑 🐕 🐩 🐈 🐄 🐃 🐂 🦬 🐐 🐏 🐖 🐑 🐕 🦮 🐕‍🦺 🐩 🐈 🐈‍⬛️
聲音	聲音 🔊
省略	省略 ……
省略号	省略号 ……
省省吧	省省吧 🙄
圣巴瑟米	圣巴瑟米 🇧🇱
圣巴泰勒米	圣巴泰勒米 🇧🇱
圣诞	圣诞 👶 👼 🎅 🤶 🧝 🧝‍♀ 🧝‍♂ 👪 🧦 🦌 🍪 🥛 🍷 🍴 ⛪ 🌟 ❄ ☃ ⛄ 🔥 🎄 🎁 🔔 🕯 🛐 ✝
圣诞岛	圣诞岛 🇨🇽
圣诞节	圣诞节 👶 👼 🎅 🤶 🧝 🧝‍♀ 🧝‍♂ 👪 🧦 🦌 🍪 🥛 🍷 🍴 ⛪ 🌟 ❄ ☃ ⛄ 🔥 🎄 🎁 🔔 🕯 🛐 ✝
圣诞老人	圣诞老人 🎅 🤶 🎅🏻 🎅🏼 🎅🏽 🎅🏾 🎅🏿 🤶🏻 🤶🏼 🤶🏽 🤶🏾 🤶🏿 🎅🏻 🧑🏻‍🎄
圣诞老爷爷	圣诞老爷爷 🎅 🎅🏻 🎅🏻
圣诞树	圣诞树 🎄
圣多美和普林西比	圣多美和普林西比 🇸🇹
圣多美普林西比	圣多美普林西比 🇸🇹
圣赫勒拿	圣赫勒拿 🇸🇭
圣赫伦那	圣赫伦那 🇸🇭
圣基茨和尼维斯	圣基茨和尼维斯 🇰🇳
圣克里斯多福及尼维斯	圣克里斯多福及尼维斯 🇰🇳
圣卢西亚	圣卢西亚 🇱🇨
圣露西亚	圣露西亚 🇱🇨
圣马力诺	圣马力诺 🇸🇲
圣马利诺	圣马利诺 🇸🇲
圣皮埃尔和密克隆	圣皮埃尔和密克隆 🇵🇲
圣皮耶与密克隆	圣皮耶与密克隆 🇵🇲
圣堂	圣堂 ⛪
圣誔老奶奶	圣誔老奶奶 🤶🏻
圣誔奶奶	圣誔奶奶 🤶🏻
圣文森及格瑞那丁	圣文森及格瑞那丁 🇻🇨
圣文森特	圣文森特 🇻🇨
圣文森特和格林纳丁斯	圣文森特和格林纳丁斯 🇻🇨
圣婴	圣婴 👼🏻
圣尤斯特歇斯	圣尤斯特歇斯 🇧🇶
圣佑达修斯	圣佑达修斯 🇧🇶
胜	胜 🉇
胜利	胜利 ✌ ✌🏻 ✌🏼 ✌🏽 ✌🏾 ✌🏿 🔱 🔱
勝利	勝利 ✌ 🔱 🔱
聖巴瑟米	聖巴瑟米 🇧🇱
聖巴泰勒米	聖巴泰勒米 🇧🇱
聖誕島	聖誕島 🇨🇽
聖誕節	聖誕節 🎄
聖誕老人	聖誕老人 🎅 🎅🏻 🎅🏻 🧑🏻‍🎄
聖誕老爺爺	聖誕老爺爺 🎅 🎅🏻 🎅🏻
聖誕樹	聖誕樹 🎄
聖多美和普林西比	聖多美和普林西比 🇸🇹
聖多美及普林西比	聖多美及普林西比 🇸🇹
聖多美普林西比	聖多美普林西比 🇸🇹
聖赫勒拿	聖赫勒拿 🇸🇭
聖赫倫那	聖赫倫那 🇸🇭
聖基茨和尼維斯	聖基茨和尼維斯 🇰🇳
聖克里斯多福及尼維斯	聖克里斯多福及尼維斯 🇰🇳
聖盧西亞	聖盧西亞 🇱🇨
聖露西亞	聖露西亞 🇱🇨
聖馬丁島	聖馬丁島 🇸🇽
聖馬力諾	聖馬力諾 🇸🇲
聖馬利諾	聖馬利諾 🇸🇲
聖皮埃爾和密克隆	聖皮埃爾和密克隆 🇵🇲
聖皮耶與密克隆	聖皮耶與密克隆 🇵🇲
聖堂	聖堂 ⛪
聖誔老奶奶	聖誔老奶奶 🤶🏻
聖誔奶奶	聖誔奶奶 🤶🏻
聖文森	聖文森 🇻🇨
聖文森及格瑞那丁	聖文森及格瑞那丁 🇻🇨
聖文森特和格林納丁斯	聖文森特和格林納丁斯 🇻🇨
聖嬰	聖嬰 👼🏻
聖尤斯特歇斯	聖尤斯特歇斯 🇧🇶
聖佑達修斯	聖佑達修斯 🇧🇶
失恋	失恋 💔
失戀	失戀 💔
失望	失望 😞 ☹ 😔 😥 ☹️ 😔 😞
狮	狮 🦁 𓃭 🦁
狮城	狮城 🇸🇬
狮子	狮子 🦁 𓃭 🦁
狮子狗	狮子狗 🐩
狮子山国	狮子山国 🇸🇱
狮子头	狮子头 🦁
狮子座	狮子座 ♌ ♌️
施工	施工 🚧 👷 🚧
獅	獅 🦁
獅城	獅城 🇸🇬
獅子	獅子 🦁
獅子狗	獅子狗 🐩
獅子山國	獅子山國 🇸🇱
獅子頭	獅子頭 🦁
獅子座	獅子座 ♌ ♌️
十	十 十、 拾 Ⅹ 〸 ⑩ ⓾ ⒑ ㊉ ㈩ 🔟 🔟
十点	十点 🕙
十点半	十点半 🕥
十点钟	十点钟 🕙
十點	十點 🕙
十點半	十點半 🕥
十點鐘	十點鐘 🕙
十二	十二 Ⅻ ⑫
十二点	十二点 🕛
十二点半	十二点半 🕧
十二点钟	十二点钟 🕛
十二點	十二點 🕛
十二點半	十二點半 🕧
十二點鐘	十二點鐘 🕛
十一	十一 Ⅺ ⑪
十一点	十一点 🕚
十一点半	十一点半 🕦
十一点钟	十一点钟 🕚
十一點	十一點 🕚
十一點半	十一點半 🕦
十一點鐘	十一點鐘 🕚
十字镐	十字镐 ⛏ ⛏️
十字鎬	十字鎬 ⛏ ⛏️
十字架	十字架 ✝ ✝️
十字路口	十字路口 🚥 🚦
石彫	石彫 🗿
石雕	石雕 🗿
石头	石头 ✊ 🪨
石頭	石頭 ✊ 🪨
石像	石像 🗿
时计	时计 ⏲ ⏲️
时间	时间 ⌚ ⌛ 🕐 🕑 🕒 🕓 🕔 🕕 🕖 🕗 🕘 🕙 🕚 🕛
识别卡	识别卡 📛
实验服	实验服 🥼
食物	食物 🍔 🍕 🍖 🍗 🍘 🍙 🍚 🍛 🍜 🍝 🍞 🍟 🍠 🍡 🍢 🍣 🍤 🍥 🍦 🍧 🍨 🍩 🍪 🍫 🍬 🍭 🍮 🍯 🍰 🍱 🍲 🍳 🍴
食盐	食盐 🧂
食鹽	食鹽 🧂
食指	食指 ☝ ☝🏻 ☝🏻️
時計	時計 ⏲ ⏲️
時間	時間 ⌚ ⌛ 🕐 🕑 🕒 🕓 🕔 🕕 🕖 🕗 🕘 🕙 🕚 🕛
實驗服	實驗服 🥼
識別卡	識別卡 📛
史巴克	史巴克 🖖 🖖🏻 🖖🏻
史波克	史波克 🖖 🖖🏻 🖖🏻
史瓦济兰	史瓦济兰 🇸🇿
史瓦濟蘭	史瓦濟蘭 🇸🇿
豕	豕 🐖
使眼色	使眼色 😉 😜
始业式	始业式 🎒
始業式	始業式 🎒
屎	屎 💩
士多店	士多店 🏪
士多啤梨	士多啤梨 🍓
示爱	示爱 😘
示愛	示愛 😘
世界	世界 🗺 🌐 🌐️
世界地图	世界地图 🗺
仕女帽	仕女帽 👒
势利	势利 🤑
饰以丝带的心	饰以丝带的心 💝
试管	试管 🧪
试剂	试剂 🧪
视频游戏	视频游戏 🎮
柿子	柿子 🍅
是嗎	是嗎 😳
是吗	是吗 😳
适合	适合 🈴
視頻游戲	視頻游戲 🎮
释然	释然 😌
勢利	勢利 🤑
飾以絲帶的心	飾以絲帶的心 💝
試管	試管 🧪
試劑	試劑 🧪
適	適 ㊜
適合	適合 🈴
釋然	釋然 😌
匙	匙 🥄
收费服务	收费服务 🈂 🈂️
收費服務	收費服務 🈂 🈂️
收件匣	收件匣 📥 📨 📥
收件箱	收件箱 📥
收件箱托盘	收件箱托盘 📥
收件箱托盤	收件箱托盤 📥
收据	收据 🧾
收據	收據 🧾
收信	收信 📩 📪 📩
收讯	收讯 📶
收訊	收訊 📶
收益	收益 🉐
收益报表	收益报表 📈
收益報表	收益報表 📈
收音机	收音机 📻
收音機	收音機 📻
收邮件	收邮件 📩
收郵件	收郵件 📩
手	手 🈐 👈 👉 ☝ 👆 🖕 👇 ✌ 🤞 🖖 🤘 🤙 🖐 ✋ 👌 👍 👎 ✊ 👊 🤛 🤜 🤚 👋 🤟 ✍ 👏 👐 🤲 👋🏻 ✋🏻
手背	手背 🤚 🤚🏻 🤚🏼 🤚🏽 🤚🏾 🤚🏿 🤚🏻
手臂	手臂 💪 🦾 💪🏻 💪🏼 💪🏽 💪🏾 💪🏿 💪🏻
手表	手表 ⌚ ⌚️
手錶	手錶 ⌚ ⌚️
手柄	手柄 🎮 🕹 🕹️
手串	手串 📿
手电	手电 🔦
手电筒	手电筒 🔦
手電	手電 🔦
手電筒	手電筒 🔦
手机	手机 📱 📲 📱
手机关机	手机关机 📴
手機	手機 📱
手機關機	手機關機 📴
手雷	手雷 💣
手枪	手枪 🔫
手槍	手槍 🔫
手球	手球 🤾‍♂ 🤾 🤾‍♀ 🤾🏻‍♂ 🤾🏼‍♂ 🤾🏽‍♂ 🤾🏾‍♂ 🤾🏿‍♂ 🤾🏻 🤾🏼 🤾🏽 🤾🏾 🤾🏿 🤾🏻‍♀ 🤾🏼‍♀ 🤾🏽‍♀ 🤾🏾‍♀ 🤾🏿‍♀ 🤾🏻
手势	手势 👈 👉 ☝ 👆 👇 🖕 👈🏻 👈🏼 👈🏽 👈🏾 👈🏿 👉🏻 👉🏼 👉🏽 👉🏾 👉🏿 ☝🏻 ☝🏼 ☝🏽 ☝🏾 ☝🏿 👆🏻 👆🏼 👆🏽 👆🏾 👆🏿 👇🏻 👇🏼 👇🏽 👇🏾 👇🏿 🖕🏻 🖕🏼 🖕🏽 🖕🏾 🖕🏿 ✊ ✋ ✌ 👊 👋 👌 👍 👎 👏 👐 🙌 🙏
手勢	手勢 ☝ ✊ ✋ ✌ 👆 👇 👈 👉 👊 👋 👌 👍 👎 👏 👐 🙌 🙏
手套	手套 🧤
手提包	手提包 👜
手推车	手推车 🛒
手推車	手推車 🛒
手写	手写 ✍ ✍🏻 ✍🏻️
手寫	手寫 ✍ ✍🏻 ✍🏻️
手心	手心 🖐 🖐🏻 🖐🏼 🖐🏽 🖐🏾 🖐🏿
手掌	手掌 ✋ ✋🏻 ✋🏻
手纸	手纸 🧻
守卫	守卫 💂 💂🏻‍♀ 💂🏻‍♂ 💂🏻
守衛	守衛 💂 💂🏻‍♀ 💂🏻‍♂ 💂🏻
首饰	首饰 💍
首飾	首飾 💍
寿司	寿司 🍣
受伤	受伤 🤕 🩸 ❤️‍🩹 🤕
受伤了	受伤了 🤕
受傷	受傷 🤕 ❤️‍🩹 🤕
受傷了	受傷了 🤕
壽司	壽司 🍣
书	书 📕 📖 📗 📘 📙 📚 📖
书包	书包 🎒
书本	书本 📖 📚 📖
书呆子	书呆子 🤓
书籍	书籍 📚
书签	书签 📑 🔖
书签标签	书签标签 📑
书写	书写 ✍ ✍🏻 ✍🏻️
書	書 📖
書包	書包 🎒
書本	書本 📖 📚 📖
書呆子	書呆子 🤓
書籍	書籍 📚
書簽	書簽 📑 🔖
書簽標簽	書簽標簽 📑
書籤	書籤 📑 🔖
書籤標籤	書籤標籤 📑
書寫	書寫 ✍ ✍🏻 ✍🏻️
舒服	舒服 ☺ 😌 ☺️
蔬菜	蔬菜 🥬 🍅 🍆 🥒 🥕 🌶 🥦 🥗 🍅 🍆 🥒 🥕 🌶 🥦 🥗 🥬 🫒 🫑 🫘
蔬菜色拉	蔬菜色拉 🥗
蔬菜沙拉	蔬菜沙拉 🥗
熟睡	熟睡 💤
属狗	属狗 🐶
属猴	属猴 🐵
属虎	属虎 🐯
属鸡	属鸡 🐔
属龙	属龙 🐲
属马	属马 🐴
属猫	属猫 🐱
属牛	属牛 🐮
属蛇	属蛇 🐍
属鼠	属鼠 🐭
属兔	属兔 🐰
属于	属于 ∈ ∉ ∊ ∋ ∌ ∍
属猪	属猪 🐷
鼠	鼠 🐭 🐁 🐀 🐹 🐿 🐀
鼠标	鼠标 🖱 🖲 🖱️
鼠標	鼠標 🖱 🖱️
鼠脸	鼠脸 🐭
鼠臉	鼠臉 🐭
鼠年	鼠年 🐭
鼠头	鼠头 🐭
鼠頭	鼠頭 🐭
薯条	薯条 🍟
薯條	薯條 🍟
薯仔	薯仔 🥔
屬狗	屬狗 🐶
屬猴	屬猴 🐵
屬虎	屬虎 🐯
屬雞	屬雞 🐔
屬龍	屬龍 🐲
屬馬	屬馬 🐴
屬貓	屬貓 🐱
屬牛	屬牛 🐮
屬蛇	屬蛇 🐍
屬鼠	屬鼠 🐭
屬兔	屬兔 🐰
屬豬	屬豬 🐷
树	树 🌳 🌴 🌲 🌲 🌳
树袋熊	树袋熊 🐨
树懒	树懒 🦥
树苗	树苗 🌱
树木	树木 🌲
树枝	树枝 🌿
竖	竖 丨
竖拇指	竖拇指 👍
竖起拇指	竖起拇指 👍
竖中指	竖中指 🖕 🖕🏻 🖕🏻
竪拇指	竪拇指 👍
竪起拇指	竪起拇指 👍
数码	数码 ⌚ 📱 💻 ⌨ 🖥 🖨 🖱 📷 📹 💾 💽 💿 📀 ⌚️ 📱 💻 ⌨️ 🖥 🖨 🖱 📷 📹 💾 💽 💿 📀
数码光碟	数码光碟 📀
数码光盘	数码光盘 📀
数学	数学 + − - × ÷ ± ∓ ∔ ⁺ ⁻ ⁼ ⁽ ⁾ ⁿ ₊ ₋ ₌ ₍ ₎ ㏍ ㎅ ㎆ ㎇ № ª º ℔ ℥ ℨ ℬ ℊ µ ℌ ℑ ℞ ℳ ℃ ℉ ℀ ℁ ℅ ℆ = ℾ ℿ ⅀ ¬ ∩ ∪ ∝ ∞ ℵ ℶ ℷ ℸ ℏ ℇ ∀ ∁ ∂ ℮ ∃ ∄ ∅ ∆ ∇ ⊂ ⊃ ⊄ ⊅ ⊆ ⊇ ⊈ ⊉ ⊊ ⊋ ∈ ∉ ∊ ∋ ∌ ∍ ∧ ∨ < > ≤ ≥ ≦ ≧ ≨ ≩ ≪ ≫ ≭ ≮ ≯ ≰ ≱ ≲ ≳ ≴ ≶ ≷ ≸ ≹ ≺ ≻ ≼ ≽ ≾ ≿ ⊀ ⊁ ∎ ∏ ∐ ∑ ∕ ∖ ∗ ∘ ∙ √ ∛ ∜ ∟ ∠ ∡ ∢ ∣ ∤ ∥ ∦ ∫ ∬ ∭ ∮ ∯ ∰ ∱ ∲ ∳ ⌠ ⎮ ⌡ ∴ ∵ ∶ ∷ ∸ ∹ ∺ ∻ ∼ ∽ ∾ ∿ ≀ ≁ ≂ ≃ ≄ ≅ ≆ ≇ ≈ ≉ ≊ ≋ ≌ ≍ ≎ ≏ ≐ ≑ ≒ ≓ ≔ ≕ ≖ ≗ ≘ ≙ ≚ ≛ ≜ ≝ ≞ ≟ ≠ ≡ ≢ ≣ ≬ ⊌ ⊍ ⊎ ⊏ ⊐ ⊑ ⊒ ⊓ ⊔ & ⅋ ⊕ ⊖ ⊗ ⊘ ⊙ ⊚ ⊛ ⊜ ⊝ ⊞ ⊟ ⊠ ⊡ ⊢ ⊣ ⊤ ⊥ ⊦ ⊧ ⊨ ⊩ ⊪ ⊫ ⊬ ⊭ ⊮ ⊯ ⊰ ⊱ ⊲ ⊳ ⊴ ⊵ ⊶ ⊷ ⊸ ⊹ ⊺ ⊻ ⊼ ⊽ ⊾ ⊿ ⋀ ⋁ ⋂ ⋃ ⋄ ⋅ ⋆ ⋇ ⋈ ⋉ ⋊ ⋋ ⋌ ⋍ ⋎ ⋏ ⋐ ⋑ ⋒ ⋓ ⋔ ⋕ ⋖ ⋗ ⋘ ⋙ ⋚ ⋛ ⋜ ⋝ ⋞ ⋟ ⋠ ⋡ ⋢ ⋣ ⋤ ⋥ ⋦ ⋧ ⋨ ⋩ ⋪ ⋫ ⋬ ⋭ ⋮ ⋯ ⋰ ⋱ ⨀ ⨦ ⨯ ⨸
数字	数字 🔢 № ⓪ ① ② ③ ④ ⑤ ⑥ ⑦ ⑧ ⑨ ⑩ ⑪ ⑫ ⑬ ⑭ ⑮ ⑯ ⑰ ⑱ ⑲ ⑳ ㉑ ㉒ ㉓ ㉔ ㉕ ㉖ ㉗ ㉘ ㉙ ㉚ ㉛ ㉜ ㉝ ㉞ ㉟ ㊱ ㊲ ㊳ ㊴ ㊵ ㊶ ㊷ ㊸ ㊹ ㊺ ㊻ ㊼ ㊽ ㊾ ㊿ ⓿ ❶ ❷ ❸ ❹ ❺ ❻ ❼ ❽ ❾ ❿ ⓫ ⓬ ⓭ ⓮ ⓯ ⓰ ⓱ ⓲ ⓳ ⓴ 🔢
数字光碟	数字光碟 📀
数字光盘	数字光盘 📀
数字键盘	数字键盘 🔢
豎中指	豎中指 🖕 🖕🏻 🖕🏻
數碼	數碼 ⌚ 📱 💻 ⌨ 🖥 🖨 🖱 📷 📹 💾 💽 💿 📀 ⌚️ 📱 💻 ⌨️ 🖥 🖨 🖱 📷 📹 💾 💽 💿 📀
數碼光碟	數碼光碟 📀
數碼光盤	數碼光盤 📀
數字	數字 🔢
數字光碟	數字光碟 📀
數字光盤	數字光盤 📀
數字鍵盤	數字鍵盤 🔢
樹	樹 🌲 🌳 🌴 🌲 🌳
樹袋熊	樹袋熊 🐨
樹苗	樹苗 🌱
樹木	樹木 🌲
樹枝	樹枝 🌿
摔跤	摔跤 🤼‍♂ 🤼 🤼‍♀ 🤼🏻
双	双 🈒
双版	双版 ⛷
双版滑雪	双版滑雪 ⛷
双胞	双胞 👨‍👩‍👦‍👦 👨‍👩‍👧‍👦 👨‍👩‍👧‍👧
双胞胎	双胞胎 👨‍👩‍👦‍👦 👨‍👩‍👧‍👦 👨‍👩‍👧‍👧
双峰骆驼	双峰骆驼 🐫
双峰驼	双峰驼 🐫
双凤之家	双凤之家 👨‍👩‍👧‍👧
双簧	双簧 🎭
双肩包	双肩包 🎒
双惊叹号	双惊叹号 ‼
双龙之家	双龙之家 👨‍👩‍👦‍👦
双目	双目 👀 👀 👀
双人	双人 👥
双手	双手 👐 🤲 👐🏻 👐🏼 👐🏽 👐🏾 👐🏿 🤲🏻 🤲🏼 🤲🏽 🤲🏾 🤲🏿
双叹号	双叹号 ‼ ‼️
双弯曲线	双弯曲线 ➿
双眼	双眼 👀
双鱼座	双鱼座 ♓ ♓️
双掌	双掌 👐
双子座	双子座 ♊ ♊️
霜淇淋	霜淇淋 🍦
雙版	雙版 ⛷
雙版滑雪	雙版滑雪 ⛷
雙胞	雙胞 👨‍👩‍👦‍👦 👨‍👩‍👧‍👦 👨‍👩‍👧‍👧
雙胞胎	雙胞胎 👨‍👩‍👦‍👦 👨‍👩‍👧‍👦 👨‍👩‍👧‍👧
雙峯駱駝	雙峯駱駝 🐫
雙峰駱駝	雙峰駱駝 🐫
雙峰駝	雙峰駝 🐫
雙鳳之家	雙鳳之家 👨‍👩‍👧‍👧
雙簧	雙簧 🎭
雙肩包	雙肩包 🎒
雙驚嘆號	雙驚嘆號 ‼
雙龍之家	雙龍之家 👨‍👩‍👦‍👦
雙目	雙目 👀 👀 👀
雙人	雙人 👥
雙嘆號	雙嘆號 ‼ ‼️
雙彎曲線	雙彎曲線 ➿
雙眼	雙眼 👀
雙魚座	雙魚座 ♓ ♓️
雙掌	雙掌 👐
雙子座	雙子座 ♊ ♊️
爽	爽 ☺ ☺️
水	水 ㊌ ㈬ 💧 🚰 💧
水笔	水笔 🖋 🖋️
水筆	水筆 🖋 🖋️
水稻	水稻 🌾
水滴	水滴 💧
水果	水果 🍅 🍆 🍇 🍈 🍉 🍊 🍋 🍌 🍍 🍎 🍏 🍐 🍑 🍒 🍓 🥝 🥑 🥥 🥭 🍏 🍎 🍐 🍊 🍋 🍌 🍉 🍇 🍓 🫐 🍈 🍒 🍑 🍍 🥝 🥑 🥥 🥭
水果刀	水果刀 🔪
水饺	水饺 🥟
水餃	水餃 🥟
水晶球	水晶球 🔮
水龙头	水龙头 🚰
水龍頭	水龍頭 🚰
水蜜桃	水蜜桃 🍑
水牛	水牛 🐃
水瓶座	水瓶座 ♒ ♒️
水枪	水枪 🔫
水槍	水槍 🔫
水球	水球 🤽‍♂ 🤽 🤽‍♀ 🤽🏻‍♂ 🤽🏼‍♂ 🤽🏽‍♂ 🤽🏾‍♂ 🤽🏿‍♂ 🤽🏻 🤽🏼 🤽🏽 🤽🏾 🤽🏿 🤽🏻‍♀ 🤽🏼‍♀ 🤽🏽‍♀ 🤽🏾‍♀ 🤽🏿‍♀ 🤽🏻
水獭	水獭 🦦
水战	水战 🔫
水戰	水戰 🔫
水族馆	水族馆 🐳
水族館	水族館 🐳
睡吧	睡吧 😴
睡觉	睡觉 😴 😪 💤 🛌 😴 🛌🏻
睡覺	睡覺 💤 😪 😴 🛌 😴 🛌🏻
睡了	睡了 💤 😴
睡睰睰	睡睰睰 💤
睡眠	睡眠 🛌
睡著	睡著 💤
说	说 🗣 👄
说不出	说不出 🙊
说话	说话 🗣 💬 🗯 💭 👄 🗣️
说谎	说谎 🤥
說不出	說不出 🙊
說話	說話 👄 💬 🗣 🗣️
說謊	說謊 🤥
朔	朔 🌑
硕鼠	硕鼠 🐀
碩鼠	碩鼠 🐀
司南	司南 🧭
丝带	丝带 🎗 🎀
私家车	私家车 🚗 🚘
私家車	私家車 🚗 🚘
思考	思考 🤔 🤨 🥴 🧐 💭 😔 😕 😕 🤔
思考中	思考中 💭
斯里兰卡	斯里兰卡 🇱🇰
斯里蘭卡	斯里蘭卡 🇱🇰
斯洛伐克	斯洛伐克 🇸🇰
斯洛维尼亚	斯洛维尼亚 🇸🇮
斯洛維尼亞	斯洛維尼亞 🇸🇮
斯洛文尼亚	斯洛文尼亚 🇸🇮
斯诺克	斯诺克 🎱
斯諾克	斯諾克 🎱
斯威士兰	斯威士兰 🇸🇿
斯威士蘭	斯威士蘭 🇸🇿
絲帶	絲帶 🎀
撕开的日暦	撕开的日暦 📆
撕開的日暦	撕開的日暦 📆
死定了	死定了 😠 😾
死火山	死火山 🗻
死亡	死亡 💀
死猪	死猪 🐖
死豬	死豬 🐖
四	四 四、 肆 Ⅳ 〤 ⁴ ₄ ⓸ 𝟜 ⒋ 🄅 ㊃ ㈣ 4⃣ 𓃌 4️⃣
四边形	四边形 ⎕ ⏥
四点	四点 🕓
四点半	四点半 🕟
四点钟	四点钟 🕓
四點	四點 🕓
四點半	四點半 🕟
四點鐘	四點鐘 🕓
四脚蛇	四脚蛇 🦎
四腳蛇	四腳蛇 🦎
四叶草	四叶草 🍀
四葉草	四葉草 🍀
寺庙	寺庙 🛕 🛐 🛐
寺庙之国	寺庙之国 🇳🇵
寺廟	寺廟 🛐
寺廟之國	寺廟之國 🇳🇵
寺院	寺院 🛐
松饼	松饼 🍪 🍪 🥞
松鼠	松鼠 🐿 🐿️
松树	松树 🌲 🎍 🌲
松樹	松樹 🌲
蜙蝑	蜙蝑 🦗
鬆餅	鬆餅 🍪 🍪 🥞
耸肩	耸肩 🤷‍♂ 🤷 🤷‍♀ 🤷🏻‍♂ 🤷🏼‍♂ 🤷🏽‍♂ 🤷🏾‍♂ 🤷🏿‍♂ 🤷🏻 🤷🏼 🤷🏽 🤷🏾 🤷🏿 🤷🏻‍♀ 🤷🏼‍♀ 🤷🏽‍♀ 🤷🏾‍♀ 🤷🏿‍♀
搜索	搜索 🔍
搜寻	搜寻 🔍
搜尋	搜尋 🔍
苏丹	苏丹 🇸🇩
苏格兰	苏格兰 🏴󠁧󠁢󠁳󠁣󠁴󠁿
苏里南	苏里南 🇸🇷
苏利南	苏利南 🇸🇷
苏虾	苏虾 👶 👶🏻 👶🏻
蘇丹	蘇丹 🇸🇩
蘇格蘭	蘇格蘭 🏴󠁧󠁢󠁳󠁣󠁴󠁿
蘇里南	蘇里南 🇸🇷
蘇利南	蘇利南 🇸🇷
蘇蝦	蘇蝦 👶 👶🏻 👶🏻
速度	速度 ㎧
速食店	速食店 🍔
酸碱	酸碱 ㏗
蒜	蒜 🧄
算了	算了 😪 🙁
算盘	算盘 🧮
算盤	算盤 🧮
随便	随便 😶
随机播放	随机播放 🔀
隨便	隨便 😶
隨機播放	隨機播放 🔀
碎花彩球	碎花彩球 🎊
孙女	孙女 👧 👧🏻 👧🏻
孙子	孙子 👦 👦🏻 👦🏻
孫女	孫女 👧 👧🏻 👧🏻
孫子	孫子 👦 👦🏻 👦🏻
所罗门群岛	所罗门群岛 🇸🇧
所羅門群島	所羅門群島 🇸🇧
所以	所以 ∴
所以呢	所以呢 💁 🤷🏻‍♀ 🤷🏻‍♂ 🤷🏻
索罗门群岛	索罗门群岛 🇸🇧
索羅門群島	索羅門群島 🇸🇧
索马里	索马里 🇸🇴
索马利亚	索马利亚 🇸🇴
索馬里	索馬里 🇸🇴
索馬利亞	索馬利亞 🇸🇴
索引卡	索引卡 📇
锁	锁 🔒 🔓 🔏 🔐 🔒
锁定	锁定 🔒
锁匙	锁匙 🔑
鎖	鎖 🔒
鎖定	鎖定 🔒
鎖匙	鎖匙 🔑
他	他 👤
他们	他们 👥
他們	他們 👥
她	她 👤
她们	她们 👥
她們	她們 👥
塔	塔 🗼
塔吉克	塔吉克 🇹🇯
塔吉克斯坦	塔吉克斯坦 🇹🇯
塔可	塔可 🌮
踏板车	踏板车 🛴
踏板車	踏板車 🛴
台风	台风 🌀
台历	台历 📆
台球	台球 🎱
台式机	台式机 🖥 🖥️
台湾	台湾 🇹🇼
台灣	台灣 🇹🇼
跆拳道	跆拳道 🥋
臺曆	臺曆 📆
臺式機	臺式機 🖥 🖥️
臺灣	臺灣 🇹🇼
颱風	颱風 🌀
檯球	檯球 🎱
太感谢	太感谢 🙏 🙏🏻 🙏🏻
太感謝	太感謝 🙏 🙏🏻 🙏🏻
太好了	太好了 🙆 🙆🏻‍♀ 🙆🏻‍♂ 🙆🏻
太极	太极 ☯ ☯️
太极虎	太极虎 🇰🇷
太极旗	太极旗 🇰🇷
太極	太極 ☯ ☯️
太極虎	太極虎 🇰🇷
太極旗	太極旗 🇰🇷
太可怕	太可怕 😨
太空人	太空人 👨🏻‍🚀 👩🏻‍🚀 🧑🏻‍🚀
太难	太难 😵 😵 😵‍💫
太难了	太难了 😵
太難	太難 😵 😵 😵‍💫
太難了	太難了 😵
太阳	太阳 🌞 ☀ 🌞
太阳花	太阳花 🌻
太阳镜	太阳镜 🕶 😎 🕶️
太阳菊	太阳菊 🌼
太阳伞	太阳伞 ☂ ☂️
太阳神	太阳神 🌞
太陽	太陽 ☀ 🌞 🌞
太陽花	太陽花 🌻
太陽鏡	太陽鏡 🕶 🕶️
太陽菊	太陽菊 🌼
太陽傘	太陽傘 ☂ ☂️
太陽神	太陽神 🌞
太阴	太阴 🌝
太陰	太陰 🌝
太子	太子 🤴🏻
泰迪熊	泰迪熊 🧸
泰国	泰国 🇹🇭
泰國	泰國 🇹🇭
贪	贪 🤑
摊开手	摊开手 👐
摊手	摊手 🤷‍♂ 🤷 🤷‍♀ 🤷🏻‍♂ 🤷🏼‍♂ 🤷🏽‍♂ 🤷🏾‍♂ 🤷🏿‍♂ 🤷🏻 🤷🏼 🤷🏽 🤷🏾 🤷🏿 🤷🏻‍♀ 🤷🏼‍♀ 🤷🏽‍♀ 🤷🏾‍♀ 🤷🏿‍♀ 🤷🏻
攤開手	攤開手 👐
坛	坛 ⚱
坦桑尼亚	坦桑尼亚 🇹🇿
坦桑尼亞	坦桑尼亞 🇹🇿
坦尚尼亚	坦尚尼亚 🇹🇿
坦尚尼亞	坦尚尼亞 🇹🇿
叹	叹 ❕ ❗ ‼ ⁉ 😮 😲 ¡
叹号	叹号 ❕ ❗ ‼ ⁉ ¡ ❕ ❗️
叹气	叹气 😔 😮‍💨
叹问号	叹问号 ⁉ ⁉️
探長	探長 🕵 🕵🏻‍♀ 🕵🏻‍♂ 🕵🏻
探长	探长 🕵‍♂ 🕵 🕵‍♀ 🕵🏻‍♂ 🕵🏼‍♂ 🕵🏽‍♂ 🕵🏾‍♂ 🕵🏿‍♂ 🕵🏻 🕵🏼 🕵🏽 🕵🏾 🕵🏿 🕵🏻‍♀ 🕵🏼‍♀ 🕵🏽‍♀ 🕵🏾‍♀ 🕵🏿‍♀ 🕵🏻
嘆號	嘆號 ❕ ❗ ❕ ❗️
嘆氣	嘆氣 😔 😮‍💨
嘆問號	嘆問號 ⁉ ⁉️
汤	汤 🥣
汤加	汤加 🇹🇴
汤面	汤面 🍜
汤匙	汤匙 🥄
湯加	湯加 🇹🇴
湯麵	湯麵 🍜
糖	糖 🍬 🍭 🍬
糖果	糖果 🍬 🍭 🍬
糖果球	糖果球 🎊
糖菓球	糖菓球 🎊
糖葫芦	糖葫芦 🍡
糖葫蘆	糖葫蘆 🍡
烫	烫 🥵
烫口	烫口 🥵
燙	燙 🥵
燙口	燙口 🥵
逃	逃 🏃‍♂ 🏃 🏃‍♀ 💨 🏃🏻‍♂ 🏃🏼‍♂ 🏃🏽‍♂ 🏃🏾‍♂ 🏃🏿‍♂ 🏃🏻 🏃🏼 🏃🏽 🏃🏾 🏃🏿 🏃🏻‍♀ 🏃🏼‍♀ 🏃🏽‍♀ 🏃🏾‍♀ 🏃🏿‍♀
逃离	逃离 💨
逃離	逃離 💨
逃跑	逃跑 💨
桃	桃 🍑
桃花	桃花 🌸
桃心	桃心 ♥ ❤
桃子	桃子 🍑
讨厌	讨厌 🙃 🙄 😣 😩 🥴 😣 😩 🥴
討厭	討厭 😣 😩 🥴
套餐	套餐 🍱
特	特 ㊕ ㈵
特价	特价 🉐
特價	特價 🉐
特克斯和凯科斯群岛	特克斯和凯科斯群岛 🇹🇨
特克斯和凱科斯群島	特克斯和凱科斯群島 🇹🇨
特里斯坦达库尼亚	特里斯坦达库尼亚 🇸🇭
特里斯坦達庫尼亞	特里斯坦達庫尼亞 🇸🇭
特立尼达和多巴哥	特立尼达和多巴哥 🇹🇹
特立尼達和多巴哥	特立尼達和多巴哥 🇹🇹
特殊符号	特殊符号 🔣
特殊符號	特殊符號 🔣
梯度	梯度 ∇ gradient
梯形	梯形 ⏢
踢球	踢球 ⚽
提款	提款 🏧
提款机	提款机 🏧
提款機	提款機 🏧
提琴	提琴 🎻
提取行李	提取行李 🛄
提醒	提醒 ⏰ 🔔 🔔
体操	体操 🤸‍♂ 🤸 🤸‍♀ 🤸🏻‍♂ 🤸🏼‍♂ 🤸🏽‍♂ 🤸🏾‍♂ 🤸🏿‍♂ 🤸🏻 🤸🏼 🤸🏽 🤸🏾 🤸🏿 🤸🏻‍♀ 🤸🏼‍♀ 🤸🏽‍♀ 🤸🏾‍♀ 🤸🏿‍♀ 🤸🏻
体积	体积 ㎣ ㎤ ㎥ ㎦ ㎕ ㎖ ㎗ ㎘ ㍑
体温计	体温计 🌡 🌡️
体育场	体育场 🏟 🏟️
体育馆	体育馆 🏟 🏟️
體操	體操 🤸🏻‍♀ 🤸🏻‍♂ 🤸🏻
體溫計	體溫計 🌡 🌡️
體育場	體育場 🏟 🏟️
體育館	體育館 🏟 🏟️
剃头	剃头 💇 💇🏻‍♀ 💇🏻‍♂ 💇🏻
剃頭	剃頭 💇 💇🏻‍♀ 💇🏻‍♂ 💇🏻
剃须刀	剃须刀 🪒
天	天 🈗
天啊	天啊 😟 😦 😱 🙀 🤯 😱 🙀 🤯
天才	天才 😇
天秤座	天秤座 ♎ ♎️
天鹅	天鹅 🦢
天鵝	天鵝 🦢
天房	天房 🕋
天妇罗	天妇罗 🍤
天婦羅	天婦羅 🍤
天干	天干 甲 乙 丙 丁 戊 己 庚 辛 壬 癸
天狗	天狗 👺
天吶	天吶 😟 😱 🙀 🤯 😱 🙀 🤯
天呐	天呐 😟 😱 🙀 🤯 😱 🙀 🤯
天平	天平 ⚖ ⚖️
天枰座	天枰座 ♎ ♎️
天气	天气 ☀ 🌤 ⛅ 🌥 🌦 ☁ 🌧 ⛈ 🌩 ⚡ 🔥 💥 ❄ 🌨 ☃ ⛄ 🌬 💨 🌪 🌫 ☔ 💧 💦 🌊 🌀 🌁 🌂 ☀️ 🌤 ⛅ 🌦 🌥 ☁️ 🌨 🌧 🌩 ⛈ ❄️ 💨 🌪 🌫 🌊
天氣	天氣 ☀ ☁ ☔ ⛄ ⛅ ❄ 🌀 🌁 🌂 🌤 🌦 🌥 🌨 🌧 🌩 ⛈ 💨 🌪 🌫 🌊 ☀️ 🌤 ⛅ 🌦 🌥 ☁️ 🌨 🌧 🌩 ⛈ ❄️ 💨 🌪 🌫 🌊
天晴	天晴 ☀ ☀️
天使	天使 😇 👼 👼🏻 👼🏻
天使宝宝	天使宝宝 👼
天使寶寶	天使寶寶 👼
天文	天文 ✨ 🌌 🌑 🌒 🌓 🌔 🌕 🌖 🌗 🌘 🌙 🌚 🌛 🌜 🌝 🌞 🌟 🌠 🔭
天文观察	天文观察 🔭
天文觀察	天文觀察 🔭
天线	天线 📡
天線	天線 📡
天蝎座	天蝎座 ♏ ♏️
天蠍座	天蠍座 ♏ ♏️
天阴	天阴 🌥 🌥️
天陰	天陰 🌥 🌥️
天主教堂	天主教堂 ⛪ ⛪️
田径	田径 🏃🏻‍♀ 🏃🏻‍♂ 🏃🏻
田徑	田徑 🏃🏻‍♀ 🏃🏻‍♂ 🏃🏻
甜点	甜点 🍮 🍩 🍪 🍧 🍨 🍦 🍰 🧁 🍮 🍩 🍪 🍧 🍨 🍦 🍰 🧁 🧇 🧆 🧁
甜點	甜點 🍮 🧁 🍩 🍪 🍧 🍨 🍦 🍰 🍮 🍩 🍪 🍧 🍨 🍦 🍰 🧁 🧇 🧆 🧁
甜瓜	甜瓜 🍈
甜品	甜品 🍮
甜食	甜食 🍯 🍰 🍮 🎂 🍭 🍬 🍫 🍩 🍪 🍦 🧁
甜甜圈	甜甜圈 🍩
甜筒	甜筒 🍦
条	条 🀐 🀑 🀒 🀓 🀔 🀕 🀖 🀗 🀘
条城	条城 🏯
条幅星	条幅星 ❇
条子	条子 👮 👮🏻‍♀ 👮🏻‍♂ 👮🏻
條城	條城 🏯
條幅星	條幅星 ❇
條子	條子 👮 👮🏻‍♀ 👮🏻‍♂ 👮🏻
调暗	调暗 🔅
调低	调低 🔽
调高	调高 🔼
调羹	调羹 🥄
调节	调节 🎚 🎛
调亮	调亮 🔆
调皮	调皮 😛 😜 😝 🤪 🤪
调色	调色 🎨
调色板	调色板 🎨
调色盘	调色盘 🎨
笤帚	笤帚 🧹
跳动的心	跳动的心 💓
跳動的心	跳動的心 💓
跳舞	跳舞 💃 🕺 🕺🏻 🕺🏼 🕺🏽 🕺🏾 🕺🏿 💃🏻 💃🏼 💃🏽 💃🏾 💃🏿 💃🏻 🕺🏻
铁锤	铁锤 🔨
铁道	铁道 🛤 🛤️
铁道车	铁道车 🚃
铁轨	铁轨 🛤 🛤️
铁链	铁链 ⛓ ⛓️
铁路	铁路 🛤 🛤️
铁索	铁索 ⛓ 🔗 ⛓️
铁塔	铁塔 🗼
鐵鎚	鐵鎚 🔨
鐵道	鐵道 🛤 🛤️
鐵道車	鐵道車 🚃
鐵軌	鐵軌 🛤 🛤️
鐵鏈	鐵鏈 ⛓ ⛓️
鐵路	鐵路 🛤 🛤️
鐵索	鐵索 ⛓ 🔗 ⛓️
鐵塔	鐵塔 🗼
听	听 👂 🦻 👂🏻 👂🏼 👂🏽 👂🏾 👂🏿
听不到	听不到 🙉
听不懂	听不懂 😵
听不见	听不见 🙉 🧏🏻
听不下去	听不下去 😞
听广播	听广播 📻
听筒	听筒 📞
听唔到	听唔到 🙉
听音乐	听音乐 🎧
听诊器	听诊器 🩺
聽	聽 👂
聽不到	聽不到 🙉
聽不懂	聽不懂 😵
聽不下去	聽不下去 😞
聽廣播	聽廣播 📻
聽筒	聽筒 📞
聽唔到	聽唔到 🙉
聽音樂	聽音樂 🎧
庭院	庭院 🏡
停	停 🛑 ✋ ✋🏻 ✋🏼 ✋🏽 ✋🏾 ✋🏿 ⛔ ⛔️
停车	停车 🅿 🅿️
停车场	停车场 🅿 🅿️
停車	停車 🅿 🅿️
停車場	停車場 🅿 🅿️
停止	停止 🛑 ✋ ✋🏻 ✋🏼 ✋🏽 ✋🏾 ✋🏿 ⏹ 🙌 ⏹️
停止播放	停止播放 ⏹ ⏹️
通关检查	通关检查 🛂
通關檢查	通關檢查 🛂
通过	通过 ✔ ✔️
通過	通過 ✔ ✔️
通话中	通话中 🤙🏻
通話中	通話中 🤙🏻
通心粉	通心粉 🍝
通讯	通讯 📞 📡
通訊	通訊 📞 📡
同	同 々
同性	同性 ⚢ ⚣ 🏳‍🌈 👬 👭 👨‍❤‍👨 👩‍❤‍👩 👨‍❤‍💋‍👨 👩‍❤‍💋‍👩
同性恋	同性恋 ⚢ ⚣ 🏳‍🌈 👬 👭 👨‍❤‍👨 👩‍❤‍👩 👨‍❤‍💋‍👨 👩‍❤‍💋‍👩 🏳‍🌈
同性戀	同性戀 🏳‍🌈
同意	同意 🙆
同志	同志 👬 👬🏻
铜牌	铜牌 🥉
童话	童话 👸 👿
童話	童話 👸 👿
銅牌	銅牌 🥉
统计	统计 📈 📉 📊
痛苦	痛苦 😧 😬 😖 😲
偷笑	偷笑 😏 😏 🤭
头大	头大 🤦🏻‍♀ 🤦🏻‍♂ 🤦🏻
头骨	头骨 💀
头巾	头巾 👳‍ 👳‍♂ 👳 👳‍♀ 👳🏻‍♂ 👳🏼‍♂ 👳🏽‍♂ 👳🏾‍♂ 👳🏿‍♂ 👳🏻 👳🏼 👳🏽 👳🏾 👳🏿 👳🏻‍♀ 👳🏼‍♀ 👳🏽‍♀ 👳🏾‍♀ 👳🏿‍♀ 👳🏾
头名	头名 🥇
头疼	头疼 🤦🏻‍♀ 🤦🏻‍♂ 🤦🏻
头像	头像 🎭 👤 👥 👦 👧 👨 👩 👮 👯 👰 👱 👲 👳 👴 👵 👶 👷 👸 👹 👺 👻 👼 👽 👾 👿 💀 💁 💂 💃 💆 💇 🙅 🙆 🙇 🙈 🙉 🙊 🙋 🙍 🙎
头晕目眩	头晕目眩 💫
投	投 🈧
投降	投降 🏳
投票	投票 🗳 🗳️
投票箱	投票箱 🗳 🗳️
骰子	骰子 🎲 ⚀ ⚁ ⚂ ⚃ ⚄ ⚅ 🎲
頭大	頭大 🤦🏻‍♀ 🤦🏻‍♂ 🤦🏻
頭骨	頭骨 💀
頭巾	頭巾 👳 👳🏻‍♀ 👳🏻‍♂ 👳🏾
頭名	頭名 🥇
頭疼	頭疼 🤦🏻‍♀ 🤦🏻‍♂ 🤦🏻
頭像	頭像 🎭 👤 👥 👦 👧 👨 👩 👮 👯 👰 👱 👲 👳 👴 👵 👶 👷 👸 👹 👺 👻 👼 👽 👾 👿 💀 💁 💂 💃 💆 💇 🙅 🙆 🙇 🙈 🙉 🙊 🙋 🙍 🙎
頭暈目眩	頭暈目眩 💫
禿	禿 👨🏻‍🦲 👩🏻‍🦲 🧑🏻‍🦲
禿頭	禿頭 👨🏻‍🦲 👩🏻‍🦲 🧑🏻‍🦲
秃	秃 👨‍🦲 🧑‍🦲 👩‍🦲 👨🏻‍🦲 👨🏼‍🦲 👨🏽‍🦲 👨🏾‍🦲 👨🏿‍🦲 🧑🏻‍🦲 🧑🏼‍🦲 🧑🏽‍🦲 🧑🏾‍🦲 🧑🏿‍🦲 👩🏻‍🦲 👩🏼‍🦲 👩🏽‍🦲 👩🏾‍🦲 👩🏿‍🦲 🧑🏻‍🦲
秃头	秃头 👨‍🦲 🧑‍🦲 👩‍🦲 👨🏻‍🦲 👨🏼‍🦲 👨🏽‍🦲 👨🏾‍🦲 👨🏿‍🦲 🧑🏻‍🦲 🧑🏼‍🦲 🧑🏽‍🦲 🧑🏾‍🦲 🧑🏿‍🦲 👩🏻‍🦲 👩🏼‍🦲 👩🏽‍🦲 👩🏾‍🦲 👩🏿‍🦲 🧑🏻‍🦲
突尼斯	突尼斯 🇹🇳
突尼西亚	突尼西亚 🇹🇳
突尼西亞	突尼西亞 🇹🇳
图表	图表 📉
图钉	图钉 📌 📍 📍
图瓦卢	图瓦卢 🇹🇻
涂指甲	涂指甲 💅 💅🏻 💅🏻
塗指甲	塗指甲 💅 💅🏻 💅🏻
圖表	圖表 📈 📉
圖釘	圖釘 📌 📍 📍
圖瓦盧	圖瓦盧 🇹🇻
土	土 ㊏ ㈯
土豆	土豆 🥔
土耳其	土耳其 🇹🇷
土豪	土豪 💰
土克斯及开科斯群岛	土克斯及开科斯群岛 🇹🇨
土克斯及開科斯群島	土克斯及開科斯群島 🇹🇨
土库曼	土库曼 🇹🇲
土库曼斯坦	土库曼斯坦 🇹🇲
土庫曼	土庫曼 🇹🇲
土庫曼斯坦	土庫曼斯坦 🇹🇲
土星	土星 🪐
吐	吐 🤮
吐舌	吐舌 😛
吐舌头	吐舌头 😋 😛 😛
吐舌頭	吐舌頭 😋 😛 😛
吐司	吐司 🍞
吐瓦鲁	吐瓦鲁 🇹🇻
吐瓦魯	吐瓦魯 🇹🇻
兔	兔 🐰 🐇 𓃹 🐇
兔脸	兔脸 🐰
兔臉	兔臉 🐰
兔男	兔男 👯‍♂ 👯🏻‍♂️
兔年	兔年 🐰
兔女	兔女 👯 👯🏻‍♀️
兔女郎	兔女郎 👯 👯🏻‍♀️
兔肉	兔肉 🐇
兔头	兔头 🐰
兔頭	兔頭 🐰
兔子	兔子 🐰 🐇 𓃹 🐇
兔子脸	兔子脸 🐰
兔子臉	兔子臉 🐰
团子	团子 🍡
團子	團子 🍡
糰子	糰子 🍡
推杯换盏	推杯换盏 🍻
推杯換盞	推杯換盞 🍻
腿	腿 🦵 🦿 🦵🏻 🦵🏼 🦵🏽 🦵🏾 🦵🏿 🦵🏻
退回	退回 🔙
托克劳	托克劳 🇹🇰
托克勞	托克勞 🇹🇰
托运	托运 🛄
拖拉机	拖拉机 🚜
拖拉機	拖拉機 🚜
託運	託運 🛄
脫殻而出	脫殻而出 🐣
脫氧核糖核酸	脫氧核糖核酸 🧬
脱壳而出	脱壳而出 🐣
脱氧核糖核酸	脱氧核糖核酸 🧬
哇	哇 😃 😯
哇哦	哇哦 😃 😯
哇喔	哇喔 😯
蛙	蛙 🐸 𓆏 🐸
娃	娃 👶 👶🏻 👶🏻
娃娃	娃娃 🎎 👶 👶🏻 👶🏻
瓦	瓦 ㎺ ㎻ ㎼ ㎽ ㎾ ㍗
瓦肯	瓦肯 🖖 🖖🏻 🖖🏻
瓦利斯和富图纳	瓦利斯和富图纳 🇼🇫
瓦利斯和富圖納	瓦利斯和富圖納 🇼🇫
瓦努阿图	瓦努阿图 🇻🇺
瓦努阿圖	瓦努阿圖 🇻🇺
瓦特	瓦特 ㎺ ㎻ ㎼ ㎽ ㎾ ㍗
袜	袜 🧦
袜子	袜子 🧦
襪	襪 🧦
襪子	襪子 🧦
外汇	外汇 💱 💹 💵 💶 💷 💴 💵 💶 💷 💴 💱 💹
外匯	外匯 💱 💹 💵 💶 💷 💴 💵 💶 💷 💴 💱 💹
外卖	外卖 🥡
外賣	外賣 🥡
外蒙	外蒙 🇲🇳
外蒙古	外蒙古 🇲🇳
外套	外套 🧥
外星人	外星人 👽 👾 👽
弯曲线	弯曲线 ➰
弯月	弯月 🌛 🌜
彎曲線	彎曲線 ➰
彎月	彎月 🌛 🌜
丸子	丸子 🍡
完成	完成 ✅
完了	完了 😔
玩火	玩火 🔥
玩具枪	玩具枪 🔫
玩具槍	玩具槍 🔫
玩具熊	玩具熊 🧸
玩牌	玩牌 🃏
玩笑	玩笑 😜
玩遊戲	玩遊戲 🎮
玩游戏	玩游戏 🎮
顽皮	顽皮 😜
頑皮	頑皮 😜
晚安	晚安 😴 😪 💤 🛌 💤 😴
晚上	晚上 🌃
碗	碗 🥣
碗筷	碗筷 🍽 🍽️
万	万 卍 卐 🀇 🀈 🀉 🀊 🀋 🀌 🀍 🀎 🀏
万岛国	万岛国 🇳🇴
万分	万分 ‱
万佛之国	万佛之国 🇹🇭
万那杜	万那杜 🇻🇺
万圣节	万圣节 😨 😰 😱 🤡 😈 👿 👹 👺 💀 ☠ 👻 👽 👾 🤖 🧙‍ 🧚‍ 🧛‍ 🧜‍ 🧝‍ 🧞‍ 🧟‍ 🕴 💚 🖤 🦄 🦇 🦉 🕷 🕸 🥀 🍫 🍬 🍭 🏚 🌃 🛸 🌕 🌚 🌩 ⚡ 🎃 🔮 🎭 🕯 🗡 ⛓ ⚰ ⚱ 🎃
万圣节前夕	万圣节前夕 😨 😰 😱 🤡 😈 👿 👹 👺 💀 ☠ 👻 👽 👾 🤖 🧙‍ 🧚‍ 🧛‍ 🧜‍ 🧝‍ 🧞‍ 🧟‍ 🕴 💚 🖤 🦄 🦇 🦉 🕷 🕸 🥀 🍫 🍬 🍭 🏚 🌃 🛸 🌕 🌚 🌩 ⚡ 🎃 🔮 🎭 🕯 🗡 ⛓ ⚰ ⚱
万岁	万岁 🙌 🙌🏻 🙌🏼 🙌🏽 🙌🏾 🙌🏿 🙌🏻
萬島國	萬島國 🇳🇴
萬佛之國	萬佛之國 🇹🇭
萬那杜	萬那杜 🇻🇺
萬聖節	萬聖節 🎃
萬歲	萬歲 🙌 🙌🏻 🙌🏻
腕表	腕表 ⌚
王储	王储 🤴🏻
王儲	王儲 🤴🏻
王妃	王妃 👸 👸🏻 👸🏻
王冠	王冠 👑 👑 🫅🏻
王后	王后 👸 👸🏻 👸🏻
王女	王女 👸 👸🏻 👸🏻 🤴🏻
王爷	王爷 🤴🏻
王爺	王爺 🤴🏻
王子	王子 🤴 🤴🏻 🤴🏼 🤴🏽 🤴🏾 🤴🏿 🤴🏻
网	网 🕸 🕸️
网球	网球 🎾
网球衫	网球衫 🎽
網	網 🕸 🕸️
網球	網球 🎾
網球衫	網球衫 🎽
望远镜	望远镜 🔭
望遠鏡	望遠鏡 🔭
危地马拉	危地马拉 🇬🇹
危地馬拉	危地馬拉 🇬🇹
危险	危险 ☠ ☢ ☣ ⚠ 🚨 ⚠️ 🚨
危險	危險 ⚠ 🚨 ⚠️ 🚨
威尔士	威尔士 🏴󠁧󠁢󠁷󠁬󠁳󠁿
威爾士	威爾士 🏴󠁧󠁢󠁷󠁬󠁳󠁿
威士忌	威士忌 🥃
微风	微风 🍃
微風	微風 🍃
微米	微米 ㎛
微生物	微生物 🦠
微笑	微笑 🙂 ☺ 😈 😼 🤓 😁 😃 😄 😊 😸 🙂
为何	为何 🤔
为啥	为啥 🤔
为什么	为什么 🤔
为甚么	为甚么 🤔
围脖	围脖 🧣
围巾	围巾 🧣
唯利是图	唯利是图 🤑
唯利是圖	唯利是圖 🤑
维德角	维德角 🇨🇻
圍脖	圍脖 🧣
圍巾	圍巾 🧣
爲何	爲何 🤔
爲啥	爲啥 🤔
爲甚麼	爲甚麼 🤔
維德角	維德角 🇨🇻
委內瑞拉	委內瑞拉 🇻🇪
委内瑞拉	委内瑞拉 🇻🇪
委屈	委屈 🙎 🙎🏻‍♀ 🙎🏻‍♂ 🙎🏻
猥	猥 🦔
卫兵	卫兵 💂
卫门	卫门 💂 💂🏻‍♀ 💂🏻‍♂ 💂🏻
卫生间	卫生间 🚻 🚾 🚾
卫生纸	卫生纸 🧻
卫士	卫士 💂 💂🏻‍♀ 💂🏻‍♂ 💂🏻
卫星	卫星 🛰 🛰️
卫星天线	卫星天线 📡
卫星通讯	卫星通讯 📡
未成年禁止	未成年禁止 🔞
未完成	未完成 ❎
喂奶	喂奶 🤱 🤱🏻 🤱🏼 🤱🏽 🤱🏾 🤱🏿 🍼 🧑🏻‍🍼
衛兵	衛兵 💂
衛門	衛門 💂 💂🏻‍♀ 💂🏻‍♂ 💂🏻
衛生間	衛生間 🚻 🚾 🚾
衛生紙	衛生紙 🧻
衛士	衛士 💂 💂🏻‍♀ 💂🏻‍♂ 💂🏻
衛星	衛星 🛰 🛰️
衛星天線	衛星天線 📡
衛星通訊	衛星通訊 📡
餵奶	餵奶 🍼
温度计	温度计 🌡 🌡️
温泉	温泉 ♨ ♨️
溫度計	溫度計 🌡 🌡️
溫泉	溫泉 ♨ ♨️
文	文 ㉆
文档	文档 📄
文檔	文檔 📄
文件	文件 📃 📄 📄
文件袋	文件袋 🗂 🗂️
文件档	文件档 📃
文件檔	文件檔 📃
文件柜	文件柜 🗄 🗄️
文件櫃	文件櫃 🗄 🗄️
文件夹	文件夹 📂 📁 🗂 🗃 🗄 📁
文件夾	文件夾 📁 📂 📁
文莱	文莱 🇧🇳
文书	文书 📃
文書	文書 📃
闻	闻 👃 👃🏻 👃🏼 👃🏽 👃🏾 👃🏿
蚊	蚊 🦟
蚊子	蚊子 🦟
聞	聞 👃
吻	吻 💋 😘
吻你	吻你 😘 😙 😽 😘 😙 😽 😽
问	问 ㉄ ❓ ❔ ¿ ？ ?
问号	问号 ❓ ❔ ¿ ？ ? ❓ ❔
问叹号	问叹号 ⁉ ⁉️
汶莱	汶莱 🇧🇳
汶萊	汶萊 🇧🇳
問號	問號 ❓ ❔
問嘆號	問嘆號 ⁉ ⁉️
喔	喔 😮 😶
喔耶	喔耶 ✌ ✌🏻 ✌🏻️
蜗	蜗 🐌
蜗牛	蜗牛 🐌
蝸	蝸 🐌
蝸牛	蝸牛 🐌
我爱你	我爱你 😘 🤟🏻 🤟🏻
我愛你	我愛你 😘 🤟🏻 🤟🏻
我操	我操 😧 🤬
我的天	我的天 😱 🙀
握笔	握笔 ✍ ✍🏻 ✍🏻️
握筆	握筆 ✍ ✍🏻 ✍🏻️
握手	握手 🤝 🤝🏻
乌干达	乌干达 🇺🇬
乌龟	乌龟 🐢
乌克兰	乌克兰 🇺🇦
乌拉圭	乌拉圭 🇺🇾
乌云	乌云 ☁
乌贼	乌贼 🦑
乌鱡	乌鱡 🦑
乌兹别克	乌兹别克 🇺🇿
乌兹别克斯坦	乌兹别克斯坦 🇺🇿
污染	污染 🏭 😷
巫师	巫师 🧙‍♂ 🧙 🧙‍♀ 🧙🏻‍♂ 🧙🏼‍♂ 🧙🏽‍♂ 🧙🏾‍♂ 🧙🏿‍♂ 🧙🏻 🧙🏼 🧙🏽 🧙🏾 🧙🏿 🧙🏻‍♀ 🧙🏼‍♀ 🧙🏽‍♀ 🧙🏾‍♀ 🧙🏿‍♀
呜呜	呜呜 😖
呜呜呜	呜呜呜 😖
屋	屋 🏘 🏚 🏠 🏡 ⌂ 🏠
屋企	屋企 🏠 🏡 🏠
屋子	屋子 🏘 🏚 🏠 🏡 ⌂
烏干達	烏干達 🇺🇬
烏龜	烏龜 🐢
烏克蘭	烏克蘭 🇺🇦
烏拉圭	烏拉圭 🇺🇾
烏雲	烏雲 ☁
烏鱡	烏鱡 🦑
烏茲别克	烏茲别克 🇺🇿
烏兹別克	烏兹別克 🇺🇿
烏兹別克斯坦	烏兹別克斯坦 🇺🇿
嗚嗚	嗚嗚 😖
嗚嗚嗚	嗚嗚嗚 😖
无	无 🈚 🈚️
无表情	无表情 😐
无辜	无辜 😐
无话可说	无话可说 😶
无口	无口 😶
无聊	无聊 😞 😴
无奈	无奈 🤷‍♂ 🤷 🤷‍♀ 🤷🏻‍♂ 🤷🏼‍♂ 🤷🏽‍♂ 🤷🏾‍♂ 🤷🏿‍♂ 🤷🏻 🤷🏼 🤷🏽 🤷🏾 🤷🏿 🤷🏻‍♀ 🤷🏼‍♀ 🤷🏽‍♀ 🤷🏾‍♀ 🤷🏿‍♀
无能为力	无能为力 👐 🤷🏻‍♀ 🤷🏻‍♂ 🤷🏻
无穷	无穷 ♾ ∞ #NAME? ♾️
无穷大	无穷大 ♾ ♾️
无视	无视 😾
无所谓	无所谓 💁 😌 🤷🏻‍♀ 🤷🏻‍♂ 😌 🤷🏻
无望	无望 🙍 🙍🏻‍♀ 🙍🏻‍♂ 🙍🏻
无尾熊	无尾熊 🐨
无烟区	无烟区 🚭
无邮件	无邮件 📪
无语	无语 😐 😑 😶 🤐 💬 😓 💬
无障碍	无障碍 ♿ ♿️
无障碍设施	无障碍设施 ♿ ♿️
无助	无助 😣 😫 😩 🙍 🙍🏻‍♀ 🙍🏻‍♂ 🙍🏻
唔畀睇	唔畀睇 🙈
唔畀讲	唔畀讲 🙊
唔畀講	唔畀講 🙊
唔畀听	唔畀听 🙉
唔畀聽	唔畀聽 🙉
唔得	唔得 🙅
唔关我事	唔关我事 💁 🤷🏻‍♀ 🤷🏻‍♂ 🤷🏻
唔關我事	唔關我事 💁 🤷🏻‍♀ 🤷🏻‍♂ 🤷🏻
唔好讲	唔好讲 🙊
唔好講	唔好講 🙊
唔好意思	唔好意思 🙏 🙏🏻 🙏🏻
唔明	唔明 😵 😵 😵‍💫
唔知	唔知 😲 🤷🏻‍♀ 🤷🏻‍♂ 😲 🤷🏻
無	無 🈚 🈚️
無表情	無表情 😐
無辜	無辜 😐
無話可說	無話可說 😶
無口	無口 😶
無聊	無聊 😞 😴
無能為力	無能為力 👐
無能爲力	無能爲力 🤷🏻‍♀ 🤷🏻‍♂ 🤷🏻
無窮	無窮 ♾ ♾️
無窮大	無窮大 ♾ ♾️
無視	無視 😾
無所謂	無所謂 💁 😌 🤷🏻‍♀ 🤷🏻‍♂ 😌 🤷🏻
無望	無望 🙍 🙍🏻‍♀ 🙍🏻‍♂ 🙍🏻
無尾熊	無尾熊 🐨
無煙區	無煙區 🚭
無郵件	無郵件 📪
無語	無語 💬 😓 😶 💬
無障礙	無障礙 ♿ ♿️
無障礙設施	無障礙設施 ♿ ♿️
無助	無助 🙍 🙍🏻‍♀ 🙍🏻‍♂ 🙍🏻
蜈蚣	蜈蚣 𓆨
五	五 五、 伍 Ⅴ 〥 ⁵ ₅ ⓹ 𝟝 ⒌ 🄆 ㊄ ㈤ 5⃣ 𓃍 5️⃣
五点	五点 🕔
五点半	五点半 🕠
五点钟	五点钟 🕔
五點	五點 🕔
五點半	五點半 🕠
五點鐘	五點鐘 🕔
五谷	五谷 稻 黍（黍米） 稷（小米） 麦 菽（大豆） 麻（大麻）
五官	五官 👀 👁 👂 👃 👄 👅
五行	五行 ㊎ ㊍ ㊌ ㊋ ㊏
五角星	五角星 ⭐ ⭐️
五星红旗	五星红旗 🇨🇳
五星紅旗	五星紅旗 🇨🇳
五指	五指 🖐 🖐🏻 🖐🏻
午餐	午餐 🥘 🍜 🍲 🍛 🍝 🍱 🍚 🥗
武器	武器 🔫 🗡 ⚔ 🔪 🛡 🚀 🔫 🗡 ⚔️ 🔪 🛡 🪓 🚀
武术服	武术服 🥋
武術服	武術服 🥋
捂耳朵	捂耳朵 🙉
捂脸	捂脸 🙈
捂臉	捂臉 🙈
捂嘴	捂嘴 🙊
舞	舞 💃 💃🏻 💃🏻
舞蹈	舞蹈 💃 💃🏻 💃🏻
舞蹈家	舞蹈家 💃
舞动之心	舞动之心 💞
舞動之心	舞動之心 💞
舞男	舞男 🕺🏻
舞娘	舞娘 💃 💃🏻 💃🏻
舞女	舞女 💃 💃🏻 💃🏻
舞者	舞者 💃
勿丢垃圾	勿丢垃圾 🚯
勿扰	勿扰 🔕
勿擾	勿擾 🔕
勿扔垃圾	勿扔垃圾 🚯
勿视	勿视 🙈
勿視	勿視 🙈
坞	坞 ⚓ ⚓️
塢	塢 ⚓ ⚓️
雾	雾 🌫 🌁 🌁 🌫️
雾霾	雾霾 🌁 🌫 😷 🌫️ 😷
雾蒙蒙	雾蒙蒙 🌁
雾气	雾气 🌁
霧	霧 🌁 🌫 🌁 🌫️
霧霾	霧霾 🌁 🌫 😷 🌫️ 😷
霧濛濛	霧濛濛 🌁
霧氣	霧氣 🌁
夕阳	夕阳 🌆 🌇
夕陽	夕陽 🌆 🌇
西	西 🀂
西班牙	西班牙 🇪🇸
西班牙国旗	西班牙国旗 🇪🇸
西班牙國旗	西班牙國旗 🇪🇸
西部	西部 🏜 🏜️
西部牛仔	西部牛仔 🤠
西餐	西餐 🍴 🍽 🍕 🥓 🧀 🥖 🥐 🍝 🌯 🌮 🥙 🍟 🍔 🌭 🥞 🥪 🥯 🍕 🥓 🧀 🥖 🥐 🍝 🌯 🌮 🥙 🍟 🍔 🌭 🥞 🥪 🥯 🧇 🫕
西方人	西方人 👱
西瓜	西瓜 🍉
西红柿	西红柿 🍅
西紅柿	西紅柿 🍅
吸铁石	吸铁石 🧲
吸血鬼	吸血鬼 🧛‍♂ 🧛 🧛‍♀ 🧛🏻‍♂ 🧛🏼‍♂ 🧛🏽‍♂ 🧛🏾‍♂ 🧛🏿‍♂ 🧛🏻 🧛🏼 🧛🏽 🧛🏾 🧛🏿 🧛🏻‍♀ 🧛🏼‍♀ 🧛🏽‍♀ 🧛🏾‍♀ 🧛🏿‍♀ 🧛🏻
吸烟	吸烟 🚬
吸烟区	吸烟区 🚬
吸煙	吸煙 🚬
吸煙區	吸煙區 🚬
希腊	希腊 🇬🇷 αalpha βbeta γgamma δdelta εepsilon ζzeta ηeta θtheta ιiota κkappa λlambda μmu νnu ξxi οomicron πpi ρrho σsigma τtau υupsilon φphi χchi ψpsi ωomega 🇬🇷
希臘	希臘 🇬🇷
犀	犀 🦏
犀牛	犀牛 🦏
锡和橡胶王国	锡和橡胶王国 🇲🇾
蜥	蜥 🦎
蜥蜴	蜥蜴 🦎 🦕 𓆈 🦎
誒	誒 🤨
嘻嘻	嘻嘻 😁 😄 😁 🤭
錫和橡膠王國	錫和橡膠王國 🇲🇾
蟋蟀	蟋蟀 🦗
习题	习题 📖
習題	習題 📖
洗发露	洗发露 🧴
洗髮露	洗髮露 🧴
洗洁精	洗洁精 🧴
洗手间	洗手间 🚻
洗手間	洗手間 🚻
洗浴	洗浴 🛀 🛁 🛀🏻 🛀🏻 🛁
洗澡	洗澡 🛀 🚿 🛁 🛀🏻 🛀🏻 🛁
喜	喜 囍
喜爱	喜爱 😻
喜愛	喜愛 😻
喜欢	喜欢 😗 😙 😚 😍 😘 🥰 ☺ 💓 😻 ☺️ 😍 😻 🥰
喜欢你	喜欢你 😍 😻
喜歡	喜歡 ☺ 💓 😍 😻 🥰 ☺️ 😍 😻 🥰
喜歡你	喜歡你 😍 😻
喜极而泣	喜极而泣 😂 😹
喜極而泣	喜極而泣 😂 😹
戏法	戏法 🤹🏻‍♀ 🤹🏻‍♂ 🤹🏻
戏剧	戏剧 🎩 🎭 🎭
戏曲	戏曲 🎭
戏院	戏院 🎥 🎬
细菌	细菌 🦠
細菌	細菌 🦠
戲法	戲法 🤹🏻‍♀ 🤹🏻‍♂ 🤹🏻
戲劇	戲劇 🎩 🎭 🎭
戲曲	戲曲 🎭
戲院	戲院 🎥 🎬
虾	虾 🦐 🍤 🦐
虾卷	虾卷 🍤
虾蟆	虾蟆 🐸
虾米	虾米 🍤
瞎	瞎 👨‍🦯 👩‍🦯 🧑‍🦯 🦯 👨🏻‍🦯 👨🏼‍🦯 👨🏽‍🦯 👨🏾‍🦯 👨🏿‍🦯 👩🏻‍🦯 👩🏼‍🦯 👩🏽‍🦯 👩🏾‍🦯 👩🏿‍🦯 🧑🏻‍🦯 🧑🏼‍🦯 🧑🏽‍🦯 🧑🏾‍🦯 🧑🏿‍🦯
瞎话	瞎话 🤥
瞎子	瞎子 👨‍🦯 👩‍🦯 🧑‍🦯 🦯 👨🏻‍🦯 👨🏼‍🦯 👨🏽‍🦯 👨🏾‍🦯 👨🏿‍🦯 👩🏻‍🦯 👩🏼‍🦯 👩🏽‍🦯 👩🏾‍🦯 👩🏿‍🦯 🧑🏻‍🦯 🧑🏼‍🦯 🧑🏽‍🦯 🧑🏾‍🦯 🧑🏿‍🦯 🧑🏻‍🦯
蝦	蝦 🦐
蝦捲	蝦捲 🍤
蝦蟆	蝦蟆 🐸
蝦米	蝦米 🍤
下	下 ㊦ ⬇ ↓ ⇓ ⇩ ⇣ ⇊ ⬇️
下边	下边 👇 👇🏻 👇🏻
下邊	下邊 👇 👇🏻 👇🏻
下标	下标 ₀ ₁ ₂ ₃ ₄ ₅ ₆ ₇ ₈ ₉ ₊ ₋ ₌ ₍ ₎ ‸ ᴀ ₐ ᴁ ʙ ᴃ ᵦ ᴄ ᴐ ᴒ ᴅ ᴆ ᴇ ₑ ₔ ᵩ ɢ ʛ ᴦ ᵧ ʜ ₕ ɪ ᵻ ᵢ ᴊ ⱼ ᴋ ₖ ʟ ₗ ᴌ ᴧ ᴍ ₘ ꟺ ɴ ᴎ ₙ ᴏ ₒ ɶ ʘ ᴓ ᴑ ᴘ ₚ ᴨ ᴪ ʀ ᵣ ᴙ ʁ ᴚ ᵨ ₛ ᴛ ₜ ᴜ ᵤ ᵾ ᴠ ᵥ ᴡ ₓ ᵪ ʏ ᴢ ᴣ
下大雨	下大雨 ☔ ☔️
下跪	下跪 🧎‍♂ 🧎‍♀ 🧎 🧎🏻‍♂ 🧎🏼‍♂ 🧎🏽‍♂ 🧎🏾‍♂ 🧎🏿‍♂ 🧎🏻‍♀ 🧎🏼‍♀ 🧎🏽‍♀ 🧎🏾‍♀ 🧎🏿‍♀ 🧎🏻 🧎🏼 🧎🏽 🧎🏾 🧎🏿 🧎🏻
下面	下面 👇 👇🏻 👇🏻
下头	下头 👇 👇🏻 👇🏻
下頭	下頭 👇 👇🏻 👇🏻
下午	下午 ㏘
下午好	下午好 🙂
下弦月	下弦月 🌗 🌜
下雪	下雪 🌨 ❄ 🌨️
下一个	下一个 ▶
下一個	下一個 ▶
下一首	下一首 ⏭ ⏭️
下雨	下雨 ☔ 🌧 ☔️
下载	下载 ⏬
下载邮件	下载邮件 📩
下載	下載 ⏬
下載郵件	下載郵件 📩
吓	吓 😦
吓人	吓人 😱 🙀
吓死	吓死 😱 🙀
夏	夏 🀧
嚇人	嚇人 😱 🙀
嚇死	嚇死 😱 🙀
仙	仙 🧚🏻‍♀ 🧚🏻‍♂
仙贝	仙贝 🍘
仙女	仙女 🧚🏻‍♀ 🧚🏻‍♀️
仙女棒	仙女棒 🎇
仙人	仙人 🧚🏻‍♀ 🧚🏻‍♂ 🧚🏻
仙人掌	仙人掌 🌵
仙子	仙子 🧚🏻‍♂ 🧚🏻‍♂️
先生	先生 🤵🏻 🤵🏻‍♂️
鲜花	鲜花 💐
鮮花	鮮花 💐
显微镜	显微镜 🔬
顯微鏡	顯微鏡 🔬
线	线 🧵 🧶 ➰ ᝰ ︴ ﹏ ﹌ ╳ ╲ ╱ ︶ ︵ 〵 〆 〄 🧵
线轮	线轮 🧵
线圈本	线圈本 🗒 🗒️
线团	线团 🧶
线轴	线轴 🧵
馅饼	馅饼 🥧
線	線 🧵
線輪	線輪 🧵
線圈本	線圈本 🗒 🗒️
線團	線團 🧶
線軸	線軸 🧵
餡餅	餡餅 🥧
相机	相机 📷 📸 📷
相機	相機 📷
相框	相框 🖼 🖼️
相声	相声 🎭
相聲	相聲 🎭
香槟	香槟 🍾
香檳	香檳 🍾
香波	香波 🧴
香草	香草 🌿
香岛	香岛 🇰🇲
香島	香島 🇰🇲
香港	香港 🇭🇰
香瓜	香瓜 🍈
香锅	香锅 🍲
香鍋	香鍋 🍲
香蕉	香蕉 🍌
香烟	香烟 🚬
香皂	香皂 🧼
详情	详情 🔎
详细	详细 🔎
詳情	詳情 🔎
詳細	詳細 🔎
享受	享受 ☺ ☺️
响铃	响铃 🔔
响指	响指 🤞🏻
想	想 💭
想不通	想不通 🤔
想吃	想吃 😍 😻
想喫	想喫 😍 😻
想法	想法 💡 💭 💭
想吐	想吐 🤮
想想	想想 😕
想象中	想象中 💭
想要	想要 😻
響鈴	響鈴 🔔
響指	響指 🤞🏻
向钱看	向钱看 🤑
向錢看	向錢看 🤑
向日葵	向日葵 🌻
向上	向上 👆 🔼 👆🏻 👆🏻
向上符号	向上符号 ⏫
向上符號	向上符號 ⏫
向上箭头	向上箭头 ⬆
向上箭頭	向上箭頭 ⬆
向上趋势图	向上趋势图 📈
向上趨勢圖	向上趨勢圖 📈
向下	向下 👇 🔽 👇🏻 👇🏻
向下符号	向下符号 ⏬
向下符號	向下符號 ⏬
向下箭头	向下箭头 ⬇
向下箭頭	向下箭頭 ⬇
向下趋势图	向下趋势图 📉
向下趨勢圖	向下趨勢圖 📉
向下手势	向下手势 👇
向下手勢	向下手勢 👇
向右	向右 ▶ 👉 👉🏻 👉🏻
向右符号	向右符号 ⏩
向右符號	向右符號 ⏩
向右回转	向右回转 ↪
向右迴轉	向右迴轉 ↪
向右箭头	向右箭头 ➡
向右箭頭	向右箭頭 ➡
向右手势	向右手势 👉
向右手勢	向右手勢 👉
向左	向左 ◀ 👈 👈🏻 👈🏻
向左符号	向左符号 ⏪
向左符號	向左符號 ⏪
向左回转	向左回转 ↩
向左迴轉	向左迴轉 ↩
向左箭头	向左箭头 ⬅
向左箭頭	向左箭頭 ⬅
向左手势	向左手势 👈
向左手勢	向左手勢 👈
项	项 ㊠
象	象 🐘 𓃰 🐘
象棋	象棋 🩠 🩡 🩢 🩣 🩤 🩥 🩦 🩧 🩨 🩩 🩪 🩫 🩬 🩭
象形文字	象形文字 𓀀 𓀁 𓀂 𓀃 𓀄 𓀅 𓀆 𓀇 𓀈 𓀉 𓀊 𓀋 𓀌 𓀍 𓀎 𓀏 𓀐 𓀑 𓀒 𓀓 𓀔 𓀕 𓀖 𓀗 𓀘 𓀙 𓀚 𓀛 𓀜 𓀝 𓀞 𓀟 𓀠 𓀡 𓀢 𓀣 𓀤 𓀥 𓀦 𓀧 𓀨 𓀩 𓀪 𓀫 𓀬 𓀻 𓀼 𓀽 𓀾 𓀿 𓁀 𓁁 𓁂 𓁃 𓁄 𓁅 𓁆 𓁇 𓁈 𓁉 𓁟 𓁠 𓁩 𓁶 𓁷 𓃒 𓃗 𓃘 𓃝 𓃟 𓃠 𓃡 𓃩 𓃬 𓃯 𓃰 𓃱 𓃲 𓃵 𓃷 𓃻 𓅜 𓅦 𓅪 𓅭 𓅰 𓆟 𓆡 𓆏 𓃭 𓃹 𓃾 𓄿 𓆂 𓅓 𓅔 𓅡 𓅬 𓅱 𓅿 𓆈 𓆉 𓆊 𓆌 𓆋 𓆐 𓆑 𓆓 𓆕 𓆗 𓆙 𓆚 𓆞 𓆣 𓆤 𓆦 𓆧 𓆨 𓆫 𓆱 𓇳 𓇹 𓊛
象牙海岸	象牙海岸 🇨🇮
像素遊戲	像素遊戲 👾
像素游戏	像素游戏 👾
枭	枭 🦉
消防	消防 👨‍🚒 🧑‍🚒 👩‍🚒 👨🏻‍🚒 👨🏼‍🚒 👨🏽‍🚒 👨🏾‍🚒 👨🏿‍🚒 🧑🏻‍🚒 🧑🏼‍🚒 🧑🏽‍🚒 🧑🏾‍🚒 🧑🏿‍🚒 👩🏻‍🚒 👩🏼‍🚒 👩🏽‍🚒 👩🏾‍🚒 👩🏿‍🚒
消防车	消防车 🚒
消防車	消防車 🚒
消防员	消防员 👨‍🚒 🧑‍🚒 👩‍🚒 👨🏻‍🚒 👨🏼‍🚒 👨🏽‍🚒 👨🏾‍🚒 👨🏿‍🚒 🧑🏻‍🚒 🧑🏼‍🚒 🧑🏽‍🚒 🧑🏾‍🚒 🧑🏿‍🚒 👩🏻‍🚒 👩🏼‍🚒 👩🏽‍🚒 👩🏾‍🚒 👩🏿‍🚒 🧑🏻‍🚒
消防員	消防員 👨🏻‍🚒 👩🏻‍🚒 🧑🏻‍🚒
梟	梟 🦉
小	小 🤏 🤏🏻 🤏🏼 🤏🏽 🤏🏾 🤏🏿
小巴	小巴 🚐
小巴士	小巴士 🚐
小白方	小白方 ▫ ▫️
小白鼠	小白鼠 🐁
小白兔	小白兔 🐇
小包	小包 👝
小包包	小包包 👝
小丑	小丑 🤡 🃏 🤡
小醜	小醜 🤡
小船	小船 🚣
小蛋糕	小蛋糕 🍰
小刀	小刀 🔪
小岛	小岛 🏝 🏝️
小島	小島 🏝 🏝️
小滴	小滴 💧
小恶魔	小恶魔 👿
小惡魔	小惡魔 👿
小贩	小贩 👲 👲🏻 👲🏻
小販	小販 👲 👲🏻 👲🏻
小方块	小方块 ▪ ▫ ▪️ ▫️
小方塊	小方塊 ▪ ▫ ▪️ ▫️
小飞机	小飞机 🛩 🛩️
小飛機	小飛機 🛩 🛩️
小费	小费 💁‍♂ 💁 💁‍♀ 🈂 💁🏻‍♂ 💁🏼‍♂ 💁🏽‍♂ 💁🏾‍♂ 💁🏿‍♂ 💁🏻 💁🏽 💁🏾 💁🏿 💁🏻‍♀ 💁🏼‍♀ 💁🏽‍♀ 💁🏾‍♀ 💁🏿‍♀
小狗	小狗 🐶
小孩	小孩 👦 👧 🧒🏻 🧒🏻
小行星	小行星 💫
小黑方	小黑方 ▪ ▪️
小鸡	小鸡 🐣 🐤 🐥 🐤 🐥
小鸡宝宝	小鸡宝宝 🐤
小雞	小雞 🐣 🐤 🐥 🐤 🐥
小雞寶寶	小雞寶寶 🐤
小轿车	小轿车 🚗 🚘 🚗
小轎車	小轎車 🚗 🚘 🚗
小精灵	小精灵 👾
小精靈	小精靈 👾
小菱形	小菱形 🔸 🔹
小鸟	小鸟 🐦
小鳥	小鳥 🐦
小票	小票 🧾
小气	小气 🙁
小气鬼	小气鬼 🙁
小氣	小氣 🙁
小氣鬼	小氣鬼 🙁
小憩	小憩 😑
小区	小区 🏘 🏘️
小區	小區 🏘 🏘️
小三角	小三角 🔺 🔻
小声	小声 🔉 🤫
小聲	小聲 🔉 🤫
小鼠	小鼠 🐁
小说	小说 📕
小說	小說 📕
小提琴	小提琴 🎻
小童	小童 👦 👧 🧒🏻 🧒🏻
小童厕所	小童厕所 🚼
小童廁所	小童廁所 🚼
小推车	小推车 🛒
小推車	小推車 🛒
小王	小王 🃏
小写	小写 🔡
小写字母	小写字母 🔡
小寫字母	小寫字母 🔡
小心儿童	小心儿童 🚸
小心兒童	小心兒童 🚸
小学	小学 🏫
小學	小學 🏫
小样	小样 😠 😾 😏 😏 😠 😾
小樣	小樣 😠 😾 😏 😏 😠 😾
小于	小于 < ≤ ≪
小于等于	小于等于 ≤
小鱼	小鱼 🐟
小魚	小魚 🐟
小猪	小猪 🐷
小豬	小豬 🐷
晓不得	晓不得 😲 🤷🏻‍♀ 🤷🏻‍♂ 😲 🤷🏻
曉不得	曉不得 😲 🤷🏻‍♀ 🤷🏻‍♂ 😲 🤷🏻
咲	咲 😄 😊
校巴	校巴 🚍
校车	校车 🚍
校車	校車 🚍
笑	笑 😀 😁 😂 🤣 😃 😄 😅 😆 😉 😊 😋 😎 😺 😸 😹 😄 😸
笑cry	笑cry 😂 🤣 😹
笑不可抑	笑不可抑 😂 😹
笑出眼泪	笑出眼泪 😂
笑出眼淚	笑出眼淚 😂
笑哭	笑哭 😂 🤣 😹 😂 😹
笑了	笑了 😄 😸
笑脸	笑脸 ☺ 😃 😊 😁 😁 😊
笑臉	笑臉 ☺ 😃 😊 😁 😁 😊
笑容	笑容 😃 😊
笑死	笑死 🤣
笑眼	笑眼 😄
笑一个	笑一个 😬
笑一個	笑一個 😬
蝎	蝎 🦂
蝎子	蝎子 🦂 𓆫 🦂
蠍	蠍 🦂
蠍子	蠍子 🦂
协	协 ㊯ ㈿
邪恶	邪恶 😈
邪惡	邪惡 😈
斜面	斜面 ⌳
鞋	鞋 👞 👟 🥾 🥿 👠 👡 👢 🩰 👡 👢 👞 👟 🥾 🥿 👠 🛼 ⛸
鞋子	鞋子 👞 👡 👡 👢 👞 👟 🥾 🥿 👠 🛼 ⛸
写	写 ㊢ ✍ ✍🏻 ✍🏻️
写信	写信 ✉ ✍ ✍🏻 ✍🏻️
写字	写字 ✍ ✍🏻 ✍🏼 ✍🏽 ✍🏾 ✍🏿 ✍🏻️
写字楼	写字楼 🏢
写作	写作 ✍ ✏ ✍🏻 ✍🏻️
写作业	写作业 📝
寫	寫 ✍ ✍🏻 ✍🏻️
寫信	寫信 ✉ ✍ ✍🏻 ✍🏻️
寫字	寫字 ✍ ✍🏻 ✍🏻️
寫字樓	寫字樓 🏢
寫作	寫作 ✍ ✏ ✍🏻 ✍🏻️
寫作業	寫作業 📝
谢顶	谢顶 👨🏻‍🦲 👩🏻‍🦲 🧑🏻‍🦲
谢谢	谢谢 🙏 🙏🏻 🙏🏼 🙏🏽 🙏🏾 🙏🏿 😎 😎 🙏🏻
謝頂	謝頂 👨🏻‍🦲 👩🏻‍🦲 🧑🏻‍🦲
謝謝	謝謝 😎 🙏 🙏🏻 😎 🙏🏻
蟹	蟹 🦀
心	心 💘 ❤ 💓 💔 💕 💖 💗 💙 💚 🤎 🤍 💛 🧡 💜 🖤 💝 💞 💟 ❣ ♡ 🫀
心动	心动 💓
心動	心動 💓
心烦	心烦 😫
心煩	心煩 😫
心间	心间 💟
心間	心間 💟
心情	心情 💢 💣 💤 💥 💦 💧 💨 💩 💪 💫 💬 💯
心碎	心碎 💔
心叹号	心叹号 ❣ ❣️
心歎號	心歎號 ❣ ❣️
心田	心田 💟
心跳	心跳 💓 💗 💓
心形装饰	心形装饰 💟
心形裝飾	心形裝飾 💟
心型装饰	心型装饰 💟
心型裝飾	心型裝飾 💟
心有灵犀	心有灵犀 💕 💞
心有靈犀	心有靈犀 💕 💞
心之舞	心之舞 💞
辛巴威	辛巴威 🇿🇼
辛苦	辛苦 💦
新	新 🈟 🆕 🆕️
新干线	新干线 🚊
新幹線	新幹線 🚊
新加坡	新加坡 🇸🇬
新建	新建 🆕
新喀里多尼亚	新喀里多尼亚 🇳🇨
新喀里多尼亞	新喀里多尼亞 🇳🇨
新喀里多尼亞群島	新喀里多尼亞群島 🇳🇨
新款	新款 🆕 🆕️
新郎	新郎 🤵 🤵🏻 🤵🏼 🤵🏽 🤵🏾 🤵🏿 🤵🏻‍♂️
新年	新年 🎆
新娘	新娘 👰 👰🏻 👰🏼 👰🏽 👰🏾 👰🏿 👰🏻‍♀️
新娘子	新娘子 👰 👰🏻 👰🏻‍♀️
新人	新人 🤵 👰 🤵🏻 🤵🏼 🤵🏽 🤵🏾 🤵🏿 👰🏻 👰🏼 👰🏽 👰🏾 👰🏿
新手	新手 🔰
新闻	新闻 📰
新聞	新聞 📰
新西兰	新西兰 🇳🇿
新西蘭	新西蘭 🇳🇿
新邮件	新邮件 📭
新郵件	新郵件 📭
新月	新月 🌑 🌙 🌚 🌑
信	信 ✉ ✉️
信封	信封 ✉ ✉️
信号	信号 📶
信号灯	信号灯 🚥 🚦
信号状况	信号状况 📶
信號	信號 📶
信號燈	信號燈 🚥 🚦
信號狀況	信號狀況 📶
信件	信件 ✉ ✉️
信你有鬼	信你有鬼 😒
信息	信息 ℹ 💻 💼 💽 💾 💿 📀 📝 📠 📡 📢 📣 📩 📫 📮 📰 📱 📲 📳 📴 📶 📷 📹 📺 📻 📼 🔊
信箱	信箱 📪 📫 📮 📮
信用卡	信用卡 💳
星	星 ★ ☆ ⛤ ⛥ ⛦ ⛧ ✡ ❋ ❊ ❉ ❈ ❇ ❆ ❅ ❄ ❃ ❂ ❁ ❀ ✿ ✾ ✽ ✼ ✻ ✺ ✹ ✸ ✷ ✶ ✵ ✴ ✳ ✲ ✱ ✰ ✯ ✮ ✭ ✬ ✫ ✪ ✩ ✧ ✦ ✥ ✤ ✣ ✢ ⭐ ⭐️
星光	星光 🌟
星国	星国 🇸🇬
星國	星國 🇸🇬
星号	星号 ✳ ✴ ✴️
星号键	星号键 *⃣ *️⃣️
星號	星號 ✳ ✴ ✴️
星號鍵	星號鍵 *⃣ *️⃣️
星加坡	星加坡 🇸🇬
星空	星空 🌃 🌌 🌌
星芒	星芒 🌟
星期二	星期二 火曜日 かようび
星期六	星期六 土曜日 どようび
星期日	星期日 日曜日 にちようび
星期三	星期三 水曜日 すいようび
星期四	星期四 木曜日 もくようび
星期天	星期天 日曜日 にちようび
星期五	星期五 金曜日 きんようび
星期一	星期一 月曜日 げつようび
星条旗	星条旗 🇺🇸
星條旗	星條旗 🇺🇸
星系	星系 🌌
星星	星星 ⭐ 🌟 🌠 ✨ ⭐️
星星符号	星星符号 ✳
星星符號	星星符號 ✳
星星眼	星星眼 🤩
星型	星型 ✴ ✴️
星夜	星夜 🌃
星月旗	星月旗 🇹🇷
星座	星座 ♒ ♓ ♈ ♉ ♊ ♋ ♌ ♍ ♎ ♏ ♐ ♑ 水瓶座♒ 双鱼座♓ 白羊座♈ 金牛座♉ 双子座♊ 巨蟹座♋ 狮子座♌ 处女座♍ 天秤座♎ 天蝎座♏ 射手座♐ 摩羯座♑ ⛎
猩猩	猩猩 🦍 🦧 🦧
醒目	醒目 😇
兴奋	兴奋 😳
幸运	幸运 🍀
幸运饼	幸运饼 🥠
幸运草	幸运草 🍀
幸運	幸運 🍀
幸運餅	幸運餅 🥠
幸運草	幸運草 🍀
性	性 ♂ ♀ ⚢ ⚣ ⚤ ⚥ ⚦ ⚧ ⚨ ⚩ ⚪ ⚫ ⚬ ⚭ ⚮ ⚯
姓名牌	姓名牌 📛
兄弟	兄弟 👬 👬🏻
兄弟情深	兄弟情深 👨‍❤‍👨
兄弟姊妹	兄弟姊妹 👫 👫🏻
匈牙利	匈牙利 🇭🇺
胸有成竹	胸有成竹 😼
胸针	胸针 🏵 🏵️
胸針	胸針 🏵 🏵️
雄狮	雄狮 🦁
雄獅	雄獅 🦁
熊	熊 🐻 🧸 🐻
熊脸	熊脸 🐻
熊臉	熊臉 🐻
熊猫	熊猫 🐼
熊猫脸	熊猫脸 🐼
熊貓	熊貓 🐼
熊貓臉	熊貓臉 🐼
熊市	熊市 📉
休	休 ㊡ ㉁
休达	休达 🇪🇦
休旅车	休旅车 🚙
休旅車	休旅車 🚙
休息	休息 ♨ 😑 😑
休息区	休息区 ⛽
休息區	休息區 ⛽
休息室	休息室 🚻
休闲车	休闲车 🚙
休闲鞋	休闲鞋 👟
休闲装	休闲装 👕
休閒車	休閒車 🚙
休閒鞋	休閒鞋 👟
休閒裝	休閒裝 👕
修理	修理 🔧
羞	羞 😚 🙈
羞愧	羞愧 😳
羞涩	羞涩 😚
羞澀	羞澀 😚
羞羞	羞羞 😚
秀肌肉	秀肌肉 💪
绣珍光碟	绣珍光碟 💽
绣珍光盘	绣珍光盘 💽
繡珍光碟	繡珍光碟 💽
繡珍光盤	繡珍光盤 💽
裇	裇 👕 👚
嘘	嘘 🤫 🤭 🖕 🤫
噓	噓 🖕 🤫 🤫
许可	许可 🉑
许可证	许可证 🎟 🎟️
许愿	许愿 🎋
叙利亚	叙利亚 🇸🇾
叙利亞	叙利亞 🇸🇾
敘利亞	敘利亞 🇸🇾
宣誓	宣誓 ✊ ✊🏻 ✊🏻
喧哗	喧哗 🗣 🗣️
喧嘩	喧嘩 🗣 🗣️
玄武	玄武 🐢
悬浮	悬浮 🕴 🕴🏻 🕴🏼 🕴🏽 🕴🏾 🕴🏿 🕴🏻
悬浮列车	悬浮列车 🚟
旋度	旋度 ∇× curl
旋风	旋风 🌀
旋風	旋風 🌀
旋律	旋律 🎶
旋木	旋木 🎠
旋钮	旋钮 🎛 🎛️
旋鈕	旋鈕 🎛 🎛️
旋转的心	旋转的心 💞
旋转的心形	旋转的心形 💞
旋转木马	旋转木马 🎠
旋轉的心	旋轉的心 💞
旋轉的心形	旋轉的心形 💞
旋轉木馬	旋轉木馬 🎠
漩涡	漩涡 🌀
漩渦	漩渦 🌀
懸浮	懸浮 🕴🏻
懸浮列車	懸浮列車 🚟
选举	选举 🗳 🗳️
选中	选中 ☑
選舉	選舉 🗳 🗳️
選中	選中 ☑
眩晕	眩晕 😵 💫
靴	靴 👢
靴子	靴子 👢
薛定谔	薛定谔 埃尔温·薛定谔 Erwin Schrödinger
学	学 ㊫ ㈻
学姐	学姐 👩🏻‍🎓
学生	学生 👨‍🎓 🧑‍🎓 👩‍🎓 👨🏻‍🎓 👨🏼‍🎓 👨🏽‍🎓 👨🏾‍🎓 👨🏿‍🎓 🧑🏻‍🎓 🧑🏼‍🎓 🧑🏽‍🎓 🧑🏾‍🎓 🧑🏿‍🎓 👩🏻‍🎓 👩🏼‍🎓 👩🏽‍🎓 👩🏾‍🎓 👩🏿‍🎓 🤓 🤓 🧑🏻‍🎓
学士	学士 🎓 👨🏻‍🎓 👩🏻‍🎓 🎓 🧑🏻‍🎓
学士帽	学士帽 🎓
学位	学位 🎓
学校	学校 🏫
学长	学长 👨🏻‍🎓
學長	學長 👨🏻‍🎓
學姐	學姐 👩🏻‍🎓
學生	學生 🤓 👨🏻‍🎓 👩🏻‍🎓 🤓 🧑🏻‍🎓
學士	學士 🎓 👨🏻‍🎓 👩🏻‍🎓 🎓 🧑🏻‍🎓
學士帽	學士帽 🎓
學校	學校 🏫
雪	雪 ❄ 🌨 ☃ ⛄ ❄️ 🌨 ☃️ ⛄ 🧊
雪饼	雪饼 🍥
雪餅	雪餅 🍥
雪顶	雪顶 🏔 🏔️
雪頂	雪頂 🏔 🏔️
雪糕	雪糕 🍦 🍧 🍨 🧁 🍨 🧁
雪花	雪花 ❄ ❄️
雪花片	雪花片 ❄ ❄️
雪岭	雪岭 🏔 🏔️
雪嶺	雪嶺 🏔 🏔️
雪橇	雪橇 🛷
雪人	雪人 ☃ ⛄ ☃️ ⛄️
雪山	雪山 🏔 🏔️
雪杖	雪杖 🎿
血	血 🩸
血型	血型 🅰 🅱 🅾 🆎
勋章	勋章 🎖 🎖️
勳章	勳章 🎖 🎖️
循环	循环 ♻ ♳ ♴ ♵ ♶ ♷ ♸ ♹ ♺ ♲ ♼ ♽ 🔁 🔃 🔄 🔃 🔄
循環	循環 ♻ 🔁 🔃 🔄 🔃 🔄
循環播放	循環播放 🔁
讯息	讯息 ✉
訊息	訊息 ✉
巽	巽 ☴
蕈类	蕈类 🍄
蕈類	蕈類 🍄
压力	压力 ㎩ ㍱ ㎪ ㎫ ㎬
压路机	压路机 🚜
压强	压强 ㎩ ㍱ ㎪ ㎫ ㎬
压缩	压缩 🗜 🗜️
鸭	鸭 🦆 𓅿 🦆
鸭梨	鸭梨 🍐
鸭子	鸭子 🦆
孲𤘅	孲𤘅 👶 👶🏻 👶🏻
鴨	鴨 🦆
鴨子	鴨子 🦆
壓路機	壓路機 🚜
壓縮	壓縮 🗜 🗜️
牙	牙 🦷
牙齿	牙齿 🦷
牙齒	牙齒 🦷
牙买加	牙买加 🇯🇲
牙買加	牙買加 🇯🇲
亚军	亚军 🥈
亚美尼亚	亚美尼亚 🇦🇲
亚塞拜然	亚塞拜然 🇦🇿
亚森欣	亚森欣 🇸🇭
亚裔	亚裔 👨🏻 👩🏻 👴🏻 👵🏻 👦🏻 👧🏻 👶🏻 🧓🏻 🧑🏻 🧒🏻
亚洲	亚洲 🌏
亚洲澳洲	亚洲澳洲 🌏
亞軍	亞軍 🥈
亞美尼亞	亞美尼亞 🇦🇲
亞塞拜然	亞塞拜然 🇦🇿
亞森欣	亞森欣 🇸🇭
亞裔	亞裔 👨🏻 👩🏻 👴🏻 👵🏻 👦🏻 👧🏻 👶🏻 🧓🏻 🧑🏻 🧒🏻
亞洲	亞洲 🌏
亞洲澳洲	亞洲澳洲 🌏
軋路機	軋路機 🚜
烟	烟 🚬
烟囱	烟囱 🏭
烟花	烟花 🎆 🎇 🎆
烟火	烟火 🎆 🎇 🎆
菸	菸 🚬
煙	煙 🚬
煙囪	煙囪 🏭
煙花	煙花 🎆 🎇 🎆
煙火	煙火 🎆
严肃	严肃 😠
言和	言和 🤝 🤝🏻
炎热	炎热 🥵 🥵 🫠
炎熱	炎熱 🥵 🥵 🫠
研究	研究 🧐
研究员	研究员 👨🏻‍🔬 👩🏻‍🔬 🧑🏻‍🔬
研究員	研究員 👨🏻‍🔬 👩🏻‍🔬 🧑🏻‍🔬
盐	盐 🧂
嚴肅	嚴肅 😠
鹽	鹽 🧂
眼	眼 👀 👁 👁‍🗨 👁️
眼馋	眼馋 😋
眼饞	眼饞 😋
眼光	眼光 👀
眼睛	眼睛 👀 👁 👁‍🗨 👀
眼镜	眼镜 👓 🕶 👓 🕶 🥽
眼镜蛇	眼镜蛇 𓆗
眼鏡	眼鏡 👓 👓 🕶 🥽
眼泪	眼泪 😭
眼淚	眼淚 😭
眼冒金星	眼冒金星 😵
演	演 🈦
演讲	演讲 🗣 🗣️
演講	演講 🗣 🗣️
厌恶	厌恶 🙄 🙃
厌倦	厌倦 😩
焰火	焰火 🎆 🎇 🎆
厭倦	厭倦 😩
扬声器	扬声器 🔈
羊	羊 🐑 🐏 🐐 🐏 🐐
羊羔	羊羔 🐑
羊角面包	羊角面包 🥐
羊角麫包	羊角麫包 🥐
羊角麵包	羊角麵包 🥐
羊皮纸	羊皮纸 📜
羊皮紙	羊皮紙 📜
羊肉	羊肉 🐏
羊驼	羊驼 🦙
羊駝	羊駝 🦙
阳谋	阳谋 🌝
阳伞	阳伞 ☂ ☂️
洋葱	洋葱 🧅
洋酒	洋酒 🥃
洋竽	洋竽 🥔
洋装	洋装 👗
洋裝	洋裝 👗
陽謀	陽謀 🌝
陽傘	陽傘 ☂ ☂️
揚聲器	揚聲器 🔈
养神	养神 😑
养鱼	养鱼 🐠
養神	養神 😑
養魚	養魚 🐠
妖怪	妖怪 🧞‍♂ 🧞 🧞‍♀ 🧚‍♂ 🧚 🧚‍♀ 🧚🏻‍♂ 🧚🏼‍♂ 🧚🏽‍♂ 🧚🏾‍♂ 🧚🏿‍♂ 🧚🏻 🧚🏼 🧚🏽 🧚🏾 🧚🏿 🧚🏻‍♀ 🧚🏼‍♀ 🧚🏽‍♀ 🧚🏾‍♀ 🧚🏿‍♀ 👺 👻 👹 👹 👺
妖精	妖精 🧞‍♂ 🧞 🧞‍♀ 🧚‍♂ 🧚 🧚‍♀ 🧚🏻‍♂ 🧚🏼‍♂ 🧚🏽‍♂ 🧚🏾‍♂ 🧚🏿‍♂ 🧚🏻 🧚🏼 🧚🏽 🧚🏾 🧚🏿 🧚🏻‍♀ 🧚🏼‍♀ 🧚🏽‍♀ 🧚🏾‍♀ 🧚🏿‍♀ 👺 👺
妖物	妖物 👺
摇杆	摇杆 🎮 🕹 🕹️
摇滚	摇滚 🤘 🤘🏻 🤘🏼 🤘🏽 🤘🏾 🤘🏿 🤘🏻
搖桿	搖桿 🎮 🕹 🕹️
搖滾	搖滾 🤘 🤘🏻 🤘🏻
药	药 💊
药草	药草 🌿
药丸	药丸 💊
要得	要得 👌 👌🏻 👌🏻
要哭了	要哭了 😩
钥匙	钥匙 🔑 🗝 🔑
藥	藥 💊
藥丸	藥丸 💊
鑰匙	鑰匙 🔑
耶	耶 ✌ ✌🏻 ✌🏻️
椰	椰 🥥
椰蓉	椰蓉 🥥
椰肉	椰肉 🥥
椰汁	椰汁 🥥
椰子	椰子 🥥
椰子树	椰子树 🌴
椰子樹	椰子樹 🌴
爷爷	爷爷 👴 👴🏻 👴🏻
爺爺	爺爺 👴 👴🏻 👴🏻
也就这样	也就这样 😪
也就這樣	也就這樣 😪
也门	也门 🇾🇪
也門	也門 🇾🇪
野狗	野狗 🐕
野狼	野狼 🐺
野马	野马 🐎
野馬	野馬 🐎
野营	野营 ⛺ 🏕 🏕️
野營	野營 ⛺ 🏕 🏕️
野猪	野猪 🐗
野豬	野豬 🐗
业绩上涨	业绩上涨 📈
业绩下滑	业绩下滑 📉
叶	叶 🍃 🍂 🍁 🌱 🌿 🥬
叶门	叶门 🇾🇪
叶子	叶子 🍃 🍂 🍁 🌱 🌿 🥬
页	页 ㌻
页码	页码 ㌻
页面	页面 📃 📄
曳引机	曳引机 🚜
曳引機	曳引機 🚜
夜	夜 ㊰ 🌃 🌙 💫 ⭐️ 🌟 ✨ 🌛 🌜 🌃
夜间的桥	夜间的桥 🌉
夜間的橋	夜間的橋 🌉
夜景	夜景 🌃 🌉 🌃
夜空	夜空 🌙 💫 ⭐ 🌟 ✨ 🌛 🌜 🌙 💫 ⭐️ 🌟 ✨ 🌛 🌜
夜色	夜色 🌃
夜晚	夜晚 🌃 🌉 🌃
頁面	頁面 📃 📄
葉	葉 🍃 🍂 🍁 🌱 🌿 🥬
葉門	葉門 🇾🇪
葉子	葉子 🍃
業績上漲	業績上漲 📈
業績下滑	業績下滑 📉
一	一 一、 壹 Ⅰ 〡 ¹ ₁ 🈩 ⓵ 𝟙 ⒈ 🄂 ㊀ ㈠ 1⃣ 𓃉 1️⃣
一百分	一百分 💯
一杯酒	一杯酒 🥃
一边去	一边去 😛
一邊去	一邊去 😛
一点	一点 🕐
一点半	一点半 🕜
一点钟	一点钟 🕐
一點	一點 🕐
一點半	一點半 🕜
一點鐘	一點鐘 🕐
一定	一定 🙆 🙆🏻‍♀ 🙆🏻‍♂ 🙆🏻
一分钟	一分钟 ☝ ☝🏻 ☝🏻️
一分鐘	一分鐘 ☝ ☝🏻 ☝🏻️
一个	一个 ☝
一个人	一个人 👤
一個	一個 ☝
一個人	一個人 👤
一家	一家 👨‍👩‍👦 👨‍👩‍👦‍👦 👨‍👩‍👧 👨‍👩‍👧‍👦 👨‍👩‍👧‍👧 👨‍👦 👨‍👧 👨‍👧‍👦 👩‍👦 👩‍👧 👩‍👧‍👦 👨‍👦 👨‍👧 👨‍👧‍👦 👨‍👩‍👦 👨‍👩‍👦‍👦 👨‍👩‍👧 👨‍👩‍👧‍👦 👨‍👩‍👧‍👧 👩‍👦 👩‍👧 👩‍👧‍👦
一家三口	一家三口 👨‍👨‍👦 👨‍👨‍👧 👨‍👩‍👦 👨‍👩‍👧 👩‍👩‍👦 👩‍👩‍👧 👨‍👧‍👦 👩‍👧‍👦 👨‍👧‍👦 👨‍👩‍👦 👨‍👩‍👧 👩‍👧‍👦
一家四口	一家四口 👨‍👨‍👦‍👦 👨‍👨‍👧‍👦 👨‍👨‍👧‍👧 👨‍👩‍👦‍👦 👨‍👩‍👧‍👦 👨‍👩‍👧‍👧 👩‍👩‍👦‍👦 👩‍👩‍👧‍👦 👩‍👩‍👧‍👧 👨‍👩‍👦‍👦 👨‍👩‍👧‍👦 👨‍👩‍👧‍👧
一見鍾情	一見鍾情 💘
一箭穿心	一箭穿心 💘
一卷报纸	一卷报纸 🗞 🗞️
一卷報紙	一卷報紙 🗞 🗞️
一摞课本	一摞课本 📚
一摞課本	一摞課本 📚
一摞书	一摞书 📚
一摞書	一摞書 📚
一群人	一群人 👥
一人	一人 👤
一束花	一束花 💐
一索得男	一索得男 👨‍👩‍👦
一碗饭	一碗饭 🍚
一碗飯	一碗飯 🍚
一碗面	一碗面 🍜
一碗麵	一碗麵 🍜
一小会	一小会 ☝ ☝🏻 ☝🏻️
一小會	一小會 ☝ ☝🏻 ☝🏻️
一阵间	一阵间 ☝ ☝🏻 ☝🏻️
一陣間	一陣間 ☝ ☝🏻 ☝🏻️
伊拉克	伊拉克 🇮🇶
伊朗	伊朗 🇮🇷
伊斯兰	伊斯兰 🕌 🕋 ☪ 🧕 🤲 ☪️
伊斯兰教	伊斯兰教 ☪ ☪️
伊斯蘭	伊斯蘭 ☪ ☪️
伊斯蘭教	伊斯蘭教 ☪ ☪️
衣服	衣服 👔 👕 👗 👚 🧥 👚 👕 👖 🩳 👔 👗 👘 🥻 🩲 👙 🩱 🥼
衣索比亚	衣索比亚 🇪🇹
衣索比亞	衣索比亞 🇪🇹
医	医 ㊩
医疗	医疗 💉 💊 ⚕ ⚕️
医疗车	医疗车 🚑
医神权杖	医神权杖 ⚕ ⚕️
医生	医生 👨‍⚕ 🧑‍⚕ 👩‍⚕ 👨🏻‍⚕ 👨🏼‍⚕ 👨🏽‍⚕ 👨🏾‍⚕ 👨🏿‍⚕ 🧑🏻‍⚕ 🧑🏼‍⚕ 🧑🏽‍⚕ 🧑🏾‍⚕ 🧑🏿‍⚕ 👩🏻‍⚕ 👩🏼‍⚕ 👩🏽‍⚕ 👩🏾‍⚕ 👩🏿‍⚕ 🧑🏻‍⚕️
医学	医学 ⚕ ⚕️
医院	医院 🏥
医者	医者 👨🏻‍⚕ 👩🏻‍⚕ 🧑🏻‍⚕️
醫療	醫療 💉 💊 ⚕ ⚕️
醫療車	醫療車 🚑
醫神權杖	醫神權杖 ⚕ ⚕️
醫生	醫生 👨🏻‍⚕ 👩🏻‍⚕ 🧑🏻‍⚕️
醫學	醫學 ⚕ ⚕️
醫院	醫院 🏥
醫者	醫者 👨🏻‍⚕ 👩🏻‍⚕ 🧑🏻‍⚕️
咦	咦 🤨
移动的星	移动的星 💫
移动电话	移动电话 📱
移动电话关机	移动电话关机 📴
移動的星	移動的星 💫
移動電話	移動電話 📱
移動電話關機	移動電話關機 📴
遗传物质	遗传物质 🧬
疑惑	疑惑 😕 😖 🥴 🤔 🤨 ❓ ❔
疑问	疑问 ❓ ❔ 😕 😖 🤨 🤨
疑問	疑問 ❓ ❔ 😖 🤨 🤨
遺傳物質	遺傳物質 🧬
已满	已满 🈵
已滿	已滿 🈵
以色列	以色列 🇮🇱
蚁	蚁 🐜
椅	椅 💺 💺 🪑
椅子	椅子 🪑 💺 🪑
蟻	蟻 🐜
义大利	义大利 🇮🇹
义大利面	义大利面 🍝
艺人	艺人 👨🏻‍🎨 👩🏻‍🎨 🧑🏻‍🎨
艺术	艺术 🎨
艺术家	艺术家 👨🏻‍🎨 👩🏻‍🎨 🧑🏻‍🎨
异形	异形 👽
异性	异性 ⚤ 💏 👫
异性恋	异性恋 ⚤ 💏 👫
驿	驿 🚉
異形	異形 👽
意大利	意大利 🇮🇹
意大利国旗	意大利国旗 🇮🇹
意大利面	意大利面 🍝
意大利面条	意大利面条 🍝
意大利麵條	意大利麵條 🍝
意面	意面 🍝
意麵	意麵 🍝
義大利	義大利 🇮🇹
義大利國旗	義大利國旗 🇮🇹
義大利麵	義大利麵 🍝
藝人	藝人 👨🏻‍🎨 👩🏻‍🎨 🧑🏻‍🎨
藝術	藝術 🎨
藝術家	藝術家 👨🏻‍🎨 👩🏻‍🎨 🧑🏻‍🎨
驛	驛 🚉
因为	因为 ∵
阴	阴 🌥 🌥️
阴暗	阴暗 🌚
阴暗面	阴暗面 🌚
阴谋	阴谋 🌚
阴天	阴天 ⛅ ☁ 🌥 🌥️
阴阳	阴阳 ☯ ☯️
音标	音标 i: ɜ: ɑ: ɔ: u: ɪ e æ ʌ ɒ ʊ ə eɪ aɪ ɔɪ əʊ aʊ ɪə eə ʊə p t k f θ s ʃ h tʃ ts tr b d g v ð z ʒ r dʒ dz dr j w m n ŋ l
音符	音符 🎵 🎶 ♩ ♪ ♫ ♬ 🎶
音乐	音乐 🎼 🎹 🎵 🎶 𝄞 ♩ ♪ ♫ ♬ ♭ ♮ ♯ 🔀 🔁 🔂 ▶ ⏩ ◀ ⏪ 🔼 ⏫ 🔽 ⏬ ⏹ ⏏ 🎤 🎧 🎷 🎸 🎺 🎻 📯 🎵
音乐键盘	音乐键盘 🎹
音乐之邦	音乐之邦 🇦🇹
音量	音量 🔇 🔈 🔉 🔊
音调	音调 ♭ ♮ ♯
音箱	音箱 🔈
音响	音响 🔈
音響	音響 🔈
音樂	音樂 🎤 🎧 🎵 🎶 🎷 🎸 🎹 🎺 🎻 🎼 📯 🎵
音樂鍵盤	音樂鍵盤 🎹
音樂之邦	音樂之邦 🇦🇹
陰	陰 🌥 🌥️
陰暗	陰暗 🌚
陰暗面	陰暗面 🌚
陰謀	陰謀 🌚
陰天	陰天 ☁ ⛅ 🌥 🌥️
陰陽	陰陽 ☯ ☯️
银行	银行 🏦
银行卡	银行卡 💳
银河	银河 🌌
银河系	银河系 🌌
银牌	银牌 🥈
銀行	銀行 🏦
銀行卡	銀行卡 💳
銀河	銀河 🌌
銀河系	銀河系 🌌
銀牌	銀牌 🥈
引号	引号 “” ‘’ '
饮杯	饮杯 🥂
饮料	饮料 🍹 🍸 🍵 ☕ 🥛 🍷 🥃 🍶 🥂 🍾 🍻 🍺 🧃 🧉 🧋 🍹 🧃 🍸 🍵 ☕️ 🥛 🍷 🥃 🍶 🥂 🍾 🍻 🍺 🧉 🧃
饮品	饮品 🍶
饮水区	饮水区 🚰
饮用水	饮用水 🚰
隐秘	隐秘 🔏 😶‍🌫️
隐私	隐私 ㊙ 🔏
飲杯	飲杯 🥂
飲料	飲料 ☕ 🍵 🍶 🍷 🍸 🍹 🍺 🍻 🥛 🥃 🥂 🍾 🧋 🍹 🧃 🍸 🍵 ☕️ 🥛 🍷 🥃 🍶 🥂 🍾 🍻 🍺 🧉 🧃
飲品	飲品 🍶
飲水區	飲水區 🚰
飲用水	飲用水 🚰
隱秘	隱秘 🔏
隱私	隱私 ㊙ 🔏
印	印 ㊞
印度	印度 🇮🇳
印度教	印度教 🕉 🕉️ 🛕
印度尼西亚	印度尼西亚 🇮🇩
印度尼西亞	印度尼西亞 🇮🇩
印尼	印尼 🇮🇩
英镑	英镑 💷 ￡ 💷
英鎊	英鎊 💷
英标	英标 , . ? ! : ; … ~ _ - ' / @ * + ( ) () < > <> { } {} [ ] [] = % & $ | \ ♀ ♂ # ¥ £ ¢ € ^ `
英格兰	英格兰 🇬🇧 🏴󠁧󠁢󠁥󠁮󠁧󠁿 🏴󠁧󠁢󠁥󠁮󠁧󠁿
英格蘭	英格蘭 🇬🇧 🏴󠁧󠁢󠁥󠁮󠁧󠁿 🏴󠁧󠁢󠁥󠁮󠁧󠁿
英国	英国 🇬🇧 大不列颠及北爱尔兰联合王国 🇬🇧
英国国旗	英国国旗 🇬🇧
英國	英國 🇬🇧
英國國旗	英國國旗 🇬🇧
英里	英里 ㏕
英联邦	英联邦 🇬🇧
英聯邦	英聯邦 🇬🇧
英属维京群岛	英属维京群岛 🇻🇬
英属印度洋领地	英属印度洋领地 🇮🇴
英屬維京群島	英屬維京群島 🇻🇬
英屬印度洋領地	英屬印度洋領地 🇮🇴
英文大写	英文大写 🔠
英文大寫	英文大寫 🔠
英文键盘	英文键盘 🔤
英文鍵盤	英文鍵盤 🔤
英文输入法	英文输入法 🔤
英文輸入法	英文輸入法 🔤
英文小写	英文小写 🔡
英文小寫	英文小寫 🔡
英文字	英文字 🔤
英雄	英雄 🦸🏻‍♀ 🦸🏻‍♂ 🦸🏻
婴	婴 👶 👶🏻 👶🏻
婴儿	婴儿 👶 👼 🚼 👶🏻 👶🏼 👶🏽 👶🏾 👶🏿 👼🏻 👼🏼 👼🏽 👼🏾 👼🏿 👶🏻
婴儿厕所	婴儿厕所 🚼
婴孩	婴孩 👶 👶🏻 👶🏻
樱花	樱花 🌸
樱花之国	樱花之国 🇯🇵
樱桃	樱桃 🍒
鹦鹉	鹦鹉 🦜
嬰	嬰 👶 👶🏻 👶🏻
嬰兒	嬰兒 👶 🚼 👶🏻 👶🏻
嬰兒廁所	嬰兒廁所 🚼
嬰孩	嬰孩 👶 👶🏻 👶🏻
鹰	鹰 🦅 𓄿 𓆂 🦅
櫻花	櫻花 🌸
櫻花之國	櫻花之國 🇯🇵
櫻桃	櫻桃 🍒
鷹	鷹 🦅
鸚鵡	鸚鵡 🦜
荧幕	荧幕 💻
盈凸月	盈凸月 🌔
盈月	盈月 🌔
营	营 🈺 🈺️
营业	营业 🈺
营业中	营业中 🈺
営	営 🈺 🈺️
螢幕	螢幕 💻
營	營 🈺 🈺️
營業	營業 🈺
營業中	營業中 🈺
赢了	赢了 ✌
贏了	贏了 ✌
影片	影片 🎞 🎞️
影相	影相 📸
影院	影院 🎦 🎬 🎬
映	映 🈙
哟	哟 😯
喲	喲 😯
拥抱	拥抱 🤗 🤗 🫂
拥抱抱一抱	拥抱抱一抱 🤗
擁抱	擁抱 🤗 🤗 🫂
擁抱抱一抱	擁抱抱一抱 🤗
泳衣	泳衣 🩱
泳装	泳装 👙
泳裝	泳裝 👙
用餐	用餐 🍴
用户	用户 👤 👥
优	优 ㊝
忧虑	忧虑 😔
幽浮	幽浮 🛸
幽魂	幽魂 👻
幽灵	幽灵 👻
幽靈	幽靈 👻
悠悠球	悠悠球 🪀
憂慮	憂慮 😔
邮便所	邮便所 🏣
邮号	邮号 📯
邮件	邮件 📧 📨 📩 ✉ ✉️
邮局	邮局 🏣 🏤 🏤
邮轮	邮轮 🚢 🛳 🛳️
邮筒	邮筒 📮
邮箱	邮箱 📧 📨 📩 📤 📥 📮 📫 📪 📬 📭 📮
邮政号角	邮政号角 📯
邮政局	邮政局 🏤
犹太	犹太 🕍
犹太教	犹太教 ✡ ✡️
犹太教堂	犹太教堂 🕍
犹豫	犹豫 😔
油灯	油灯 🪔
油画棒	油画棒 🖍 🖍️
油畫棒	油畫棒 🖍 🖍️
油桶	油桶 🛢 🛢️
油筒	油筒 🛢 🛢️
油站	油站 ⛽ ⛽️
油棕之国	油棕之国 🇧🇯
油棕之國	油棕之國 🇧🇯
郵便所	郵便所 🏣
郵號	郵號 📯
郵件	郵件 ✉ 📧 ✉️
郵局	郵局 🏣 🏤 🏤
郵輪	郵輪 🚢 🛳 🛳️
郵筒	郵筒 📮
郵箱	郵箱 📪 📫 📬 📭 📮 📮
郵政號角	郵政號角 📯
郵政局	郵政局 🏤
鱿鱼	鱿鱼 🦑
猶太教	猶太教 ✡ ✡️
猶太教堂	猶太教堂 🕍
猶豫	猶豫 😔
遊艇	遊艇 ⛵
遊戲	遊戲 🎮 🎰 👾 🎮 👾
遊戲機	遊戲機 🎮
遊戲牌	遊戲牌 🎴
遊戲手柄	遊戲手柄 🕹 🕹️
遊樂場	遊樂場 🎠 🎡 🛝
遊樂園	遊樂園 🎠 🏟 🎡 🎢 🏟 🎡 🎢 🎠 🛝
游	游 🈫
游乐场	游乐场 🎠 🎡 🛝
游乐园	游乐园 🏟 🎡 🎢 🎠 🏟 🎡 🎢 🎠 🛝
游艇	游艇 ⛵
游戏	游戏 🎮 🎰 🎲 🎯 🎳 🎧 🎤 🎪 🎫 🎟 ♟ 🕹 🖲 🪀 👾 🎮 👾
游戏机	游戏机 🎮
游戏牌	游戏牌 🎴
游戏手柄	游戏手柄 🕹 🕹️
游泳	游泳 🏊‍♂ 🏊 🏊‍♀ 🏊🏻‍♂ 🏊🏼‍♂ 🏊🏽‍♂ 🏊🏾‍♂ 🏊🏿‍♂ 🏊🏻 🏊🏼 🏊🏽 🏊🏾 🏊🏿 🏊🏻‍♀ 🏊🏼‍♀ 🏊🏽‍♀ 🏊🏾‍♀ 🏊🏿‍♀ 🏊🏻
友好	友好 👬
友情	友情 👭
友谊	友谊 🤝 🤝🏻
友誼	友誼 🤝 🤝🏻
有	有 🈶 ㊒ ㈲ 🈶️
有病	有病 🤒
有电	有电 ⚡ ⚡️
有電	有電 ⚡ ⚡️
有毒	有毒 ☠ 🤢 ☠️ 🤢
有轨电车	有轨电车 🚃 🚋 🚎 🚋
有軌電車	有軌電車 🚃 🚋 🚎 🚋
有害	有害 ☢ ☣ 🦠 ☢️ ☣️ 🦠
有空位	有空位 🈳
有来信	有来信 📬
有來信	有來信 📬
有钱	有钱 💰
有钱人	有钱人 💰
有錢	有錢 💰
有錢人	有錢人 💰
有雾	有雾 🌁
有霧	有霧 🌁
有信寄出	有信寄出 📫
有邮件	有邮件 📫
有郵件	有郵件 📫
有雨	有雨 🌧 🌧️
有云	有云 ☁ ☁️
有雲	有雲 ☁ ☁️
右	右 ㊨ ➡ 🈮 → ⇒ ⇨ ⇢ ⇉ ➡️ 🫱🏻
右边	右边 👉 👉🏻 👉🏻 🫱🏻
右邊	右邊 👉 👉🏻 👉🏻 🫱🏻
右勾拳	右勾拳 🤛🏻
右回转	右回转 ↪
右迴轉	右迴轉 ↪
右拳	右拳 🤛🏻
右上	右上 ↗ ↗️
右上箭头	右上箭头 ↗
右上箭頭	右上箭頭 ↗
右手边	右手边 👉 👉🏻 👉🏻
右手邊	右手邊 👉 👉🏻 👉🏻
右下	右下 ↘ ↘️
右下箭头	右下箭头 ↘
右下箭頭	右下箭頭 ↘
右转	右转 ➡
右轉	右轉 ➡
幼	幼 ㉅
幼儿	幼儿 👶 👶🏻 👶🏻
幼兒	幼兒 👶 👶🏻 👶🏻
幼苗	幼苗 🌱
幼童	幼童 👶 👶🏻 👶🏻
幼稚	幼稚 😒
鼬	鼬 🦡 🦡 🦨
汙染	汙染 😷 🏭 😷
鱼	鱼 🐟 🐠 🐡 🐬 🐳 🐋 🦈 𓆞 🐠 🐟 🐡 🐬 🐳 🐋 🦈 🦭 🦦
鱼板	鱼板 🍥
鱼饼	鱼饼 🍥
鱼类	鱼类 🐟
娱乐	娱乐 🎮 🎰 🎲 🎯 🎳 🎧 🎤 🎪 🎫 🎟 ♟ 🕹 🖲 🎢 🎮 🎰 🎲 🎯 🎳 🎧 🎤️ 🎪 🎫 🎟 ♟ 🕹 🖲 🪀 🪩
娛樂	娛樂 🎢 🎤 🎮 🎰 🎲 🎯 🎳 🎧 🎪 🎫 🎟 ♟ 🕹 🖲 🎮 🎰 🎲 🎯 🎳 🎧 🎤️ 🎪 🎫 🎟 ♟ 🕹 🖲 🪀 🪩
魚	魚 🐟 🐠 🐡 🐬 🐳 🐋 🦈 🐠 🐟 🐡 🐬 🐳 🐋 🦈 🦭 🦦
魚板	魚板 🍥
魚餅	魚餅 🍥
魚類	魚類 🐟
渔	渔 🎣
瑜伽	瑜伽 🧘‍♂ 🧘 🧘‍♀ 🧘🏻‍♂ 🧘🏼‍♂ 🧘🏽‍♂ 🧘🏾‍♂ 🧘🏿‍♂ 🧘🏻 🧘🏼 🧘🏽 🧘🏾 🧘🏿 🧘🏻‍♀ 🧘🏼‍♀ 🧘🏽‍♀ 🧘🏾‍♀ 🧘🏿‍♀
愚蠢	愚蠢 🤪
漁	漁 🎣
宇航员	宇航员 👨‍🚀 🧑‍🚀 👩‍🚀 👨🏻‍🚀 👨🏼‍🚀 👨🏽‍🚀 👨🏾‍🚀 👨🏿‍🚀 🧑🏻‍🚀 🧑🏼‍🚀 🧑🏽‍🚀 🧑🏾‍🚀 🧑🏿‍🚀 👩🏻‍🚀 👩🏼‍🚀 👩🏽‍🚀 👩🏾‍🚀 👩🏿‍🚀 🧑🏻‍🚀
宇航員	宇航員 👨🏻‍🚀 👩🏻‍🚀 🧑🏻‍🚀
羽毛球	羽毛球 🏸
羽毛球拍	羽毛球拍 🏸
雨	雨 🌧 🌧️
雨伞	雨伞 🌂 ☂ ☔ 🌂
雨傘	雨傘 ☔ 🌂 🌂
语言	语言 🌐 🌐️
語言	語言 🌐 🌐️
玉米	玉米 🌽
玉米穗	玉米穗 🌽
玉蜀黍	玉蜀黍 🌽
郁金香	郁金香 🌷
郁闷	郁闷 😒 😫 😫
浴池	浴池 🛁
浴缸	浴缸 🛁
浴衣	浴衣 👘
预定	预定 🈯
預定	預定 🈯
鬱金香	鬱金香 🌷
鬱悶	鬱悶 😒 😫 😫
元素	元素 氢H 氦He 锂Li 铍Be 硼B 碳C 氮N 氧O 氟F 氖Ne 钠Na 镁Mg 铝Al 硅Si 磷P 硫S 氯Cl 氩Ar 钾K 钙Ca 钪Sc 钛Ti 钒V 铬Cr 锰Mn 铁Fe 钴Co 镍Ni 铜Cu 锌Zn 镓Ga 锗Ge 砷As 硒Se 溴Br 氪Kr 铷Rb 锶Sr 钇Y 锆Zr 铌Nb 钼Mo 锝Tc 钌Ru 铑Rh 钯Pd 银Ag 镉Cd 铟In 锡Sn 锑Sb 碲Te 碘I 氙Xe 铯Cs 钡Ba 镧La 铈Ce 镨Pr 钕Nd 钷Pm 钐Sm 铕Eu 钆Gd 铽Tb 镝Dy 钬Ho 铒Er 铥Tm 镱Yb 镥Lu 铪Hf 钽Ta 钨W 铼Re 锇Os 铱Ir 铂Pt 金Au 汞Hg 铊Tl 铅Pb 铋Bi 钋Po 砹At 氡Rn 钫Fr 镭Ra 锕Ac 钍Th 镤Pa 铀U 镎Np 钚Pu 镅Am 锔Cm 锫Bk 锎Cf 锿Es 镄Fm 钔Md 锘No 铹Lr 𬬻Rf 𬭊Db 𬭳Sg 𬭛Bh 𬭶Hs 鿏Mt 𫟼Ds 𬬭Rg 鿔Cn 鿭Nh 𫓧Fl 镆Mc 𫟷Lv 鿬Ts 鿫Og
元宵	元宵 🏮
円	円 💴
原谅我	原谅我 🙏 🙏🏻 🙏🏻
原諒我	原諒我 🙏 🙏🏻 🙏🏻
原子	原子 ⚛ ⚛️
原子笔	原子笔 🖊 🖊️
原子筆	原子筆 🖊 🖊️
原子弹	原子弹 ☢ ☢️
原子彈	原子彈 ☢ ☢️
原子能	原子能 ⚛ ⚛️
圆	圆 ⚪ ⚫ 🔴 🔵 🟠 🟡 🟢 🟣 🟤
圆领衫	圆领衫 👕
圆圈	圆圈 ⭕ ⭕️
圆图钉	圆图钉 📍
圆形	圆形 ⚪ ⚫ 🔴 🔵 🟠 🟡 🟢 🟣 🟤
圆形按钮	圆形按钮 🔘
圆月	圆月 🌕
圆珠笔	圆珠笔 🖊 🖊️
圓領衫	圓領衫 👕
圓圈	圓圈 ⭕ ⭕️
圓圖釘	圓圖釘 📍
圓形按鈕	圓形按鈕 🔘
圓月	圓月 🌕
圓珠筆	圓珠筆 🖊 🖊️
猿	猿 🦍 🦧
远大于	远大于 ≫
远小于	远小于 ≪
约旦	约旦 🇯🇴
約旦	約旦 🇯🇴
月	月 🈷 ㊊ ㈪ ㋀ ㋁ ㋂ ㋃ ㋄ ㋅ ㋆ ㋇ ㋈ ㋉ ㋋ 🌝 🈷️ 🌝
月饼	月饼 🥮
月餅	月餅 🥮
月儿	月儿 🌙
月兒	月兒 🌙
月份	月份 🈷
月光	月光 🌝
月黑风高	月黑风高 🌚
月黑風高	月黑風高 🌚
月老	月老 💘
月亮	月亮 🌝 🌚 🌑 🌒 🌓 🌔 🌕 🌖 🌗 🌘 🌙 🌛 🌜 🌕 🌝
月球	月球 🌕
月色	月色 🌃 🌙
月神	月神 🌝
月食	月食 🌑
月蚀	月蚀 🌑
月蝕	月蝕 🌑
月弯弯	月弯弯 🌛 🌜
月彎彎	月彎彎 🌛 🌜
月相	月相 🌕 🌖 🌗 🌘 🌑 🌒 🌓 🌔
月牙	月牙 🌒
月芽	月芽 🌛 🌜
月夜	月夜 🌙
月圆	月圆 🌕
月圓	月圓 🌕
阅读	阅读 📖
阅读邮件	阅读邮件 📨
跃动的心	跃动的心 💗
越南	越南 🇻🇳
越野车	越野车 🚙
越野車	越野車 🚙
閱讀	閱讀 📖
閱讀郵件	閱讀郵件 📨
樂譜	樂譜 🎼
樂器	樂器 🎻 🎸 🎹 🎷 🎺 🥁 🎻 🎸 🎹 🎷 🎺 🥁 🪕 🪘 🪗
樂曲	樂曲 🎼
躍動的心	躍動的心 💗
晕	晕 😵 😇 🥴 💫 😢 😿 😵‍💫 🥴
晕车	晕车 🥴
晕头转向	晕头转向 💫
晕眩	晕眩 💫
暈	暈 😢 😿 🥴 😵‍💫 🥴
暈車	暈車 🥴
暈頭轉向	暈頭轉向 💫
暈眩	暈眩 💫
云	云 ☁ ⛅ ⛈ 🌤 🌥 🌦 🌧 🌨 🌩 ༺ ༻ ☁️
云彩	云彩 ☁ ⛅ ⛈ 🌤 🌥 🌦 🌧 🌨 🌩 ༺ ༻
云霄飞车	云霄飞车 🎢
雲	雲 ☁ ☁️
雲霄飛車	雲霄飛車 🎢
允許	允許 ✅
允许	允许 ✅
孕妇	孕妇 🤰 🤰🏻 🤰🏼 🤰🏽 🤰🏾 🤰🏿 🤰🏻
孕婦	孕婦 🤰 🤰🏻 🤰🏼 🤰🏽 🤰🏾 🤰🏿 🤰🏻
运动	运动 🏒 🏸 🏓 🏑 🏏 ⛳ 🏹 ⚽ 🏀 🏈 🥎 🎾 🏐 🏉 🎱 ⛸ 🎿 🎳 🥏 🥍 🛹 ⛹ 🎣 🎽 🏁 🏂 🏃 🏄 🏆 🏇 🏊 🚵 🏒 🏸 🏓 🏑 🏏 ⛳ 🏹 ⚽ 🏀 🏈 ⚾️ 🥎 🎾 🏐 🏉 🎱 ⛸ 🛼 🎿 🎳 🥏 🥍 🛹 🤿 🪂 🛷 🥌 🪃 🪁
运动背心	运动背心 🎽
运动场	运动场 🏟 🏟️
运动服	运动服 🎽
运动衫	运动衫 🎽
运动鞋	运动鞋 👟
运货	运货 🚚
運動	運動 ⚽ ⛳ ⛹ 🎣 🎽 🎾 🎿 🏀 🏁 🏂 🏃 🏄 🏆 🏇 🏈 🏉 🏊 🚵 🏒 🏸 🏓 🏑 🏏 🏹 🥎 🏐 🎱 ⛸ 🎳 🥏 🥍 🛹 🏒 🏸 🏓 🏑 🏏 ⛳ 🏹 ⚽ 🏀 🏈 ⚾️ 🥎 🎾 🏐 🏉 🎱 ⛸ 🛼 🎿 🎳 🥏 🥍 🛹 🤿 🪂 🛷 🥌 🪃 🪁
運動背心	運動背心 🎽
運動場	運動場 🏟 🏟️
運動衫	運動衫 🎽
運動鞋	運動鞋 👟
運貨	運貨 🚚
杂技	杂技 🤹‍♂ 🤹‍ 🤹‍♀ 🤹🏻‍♂ 🤹🏼‍♂ 🤹🏽‍♂ 🤹🏾‍♂ 🤹🏿‍♂ 🤹🏻 🤹🏼 🤹🏽 🤹🏾 🤹🏿 🤹🏻‍♀ 🤹🏼‍♀ 🤹🏽‍♀ 🤹🏾‍♀ 🤹🏿‍♀ 🎪 🎪 🤹🏻
杂耍	杂耍 🎪 👲 👲🏻 🎪 👲🏻
杂种	杂种 🤬
砸了	砸了 😖
雜技	雜技 🎪 🤹🏻‍♀ 🤹🏻‍♂ 🎪 🤹🏻
雜耍	雜耍 🎪 👲 👲🏻 🎪 👲🏻
雜種	雜種 🤬
仔	仔 🧒🏻
仔细	仔细 🧐
仔細	仔細 🧐
再	再 🈞
再见	再见 👋 👋🏻 👋🏼 👋🏽 👋🏾 👋🏿 👋🏻
再見	再見 👋 👋🏻 👋🏻
在建	在建 🏗 🏗️
暂停	暂停 ⏸ ⏸️
暫停	暫停 ⏸ ⏸️
赞	赞 👍 👍🏻 👍🏼 👍🏽 👍🏾 👍🏿 👍🏻
赞比亚	赞比亚 🇿🇲
贊	贊 👍
贊比亞	贊比亞 🇿🇲
讚	讚 👍🏻
脏话	脏话 🤬
葬礼	葬礼 💮
葬禮	葬禮 💮
早餐	早餐 🍳 🥚 🧀 🥖 🥛 🍯 🥪 🥫 🥯 🍳 🥚 🧀 🥖 🥛 🍯 🥪 🥫 🥯 🧇 🫓
早晨	早晨 🌄
早点	早点 🍳 🥚 🧀 🥖 🥛 🍯 🥪 🥫 🥯 🍳 🥚 🧀 🥖 🥛 🍯 🥪 🥫 🥯 🧇 🫓
早點	早點 🍳 🥚 🧀 🥖 🥛 🍯 🥪 🥫 🥯 🍳 🥚 🧀 🥖 🥛 🍯 🥪 🥫 🥯 🧇 🫓
早上好	早上好 🙂
澡盆	澡盆 🛁
藻	藻 🦠
皂	皂 🧼
泽西	泽西 🇯🇪
澤西	澤西 🇯🇪
鲗	鲗 🦑
鰂	鰂 🦑
鱡	鱡 🦑
怎么会	怎么会 😢 😿
怎么可能	怎么可能 🤔
怎么样	怎么样 😏
怎麼會	怎麼會 😢 😿
怎麼可能	怎麼可能 🤔
怎麼樣	怎麼樣 😏
增高	增高 🔼
轧路机	轧路机 🚜
眨眼	眨眼 😉 😜
乍得	乍得 🇹🇩
诈骗	诈骗 💸
炸弹	炸弹 💣
炸彈	炸彈 💣
炸了	炸了 🤯
炸虾	炸虾 🍤
炸蝦	炸蝦 🍤
蚱蜢	蚱蜢 𓆧 🦗 🦗
詐騙	詐騙 💸
宅	宅 🤓 🏠 🏠
宅男	宅男 🤓 👨🏻‍💻 👨🏻‍💻
宅女	宅女 👩🏻‍💻
粘贴板	粘贴板 📋
粘貼板	粘貼板 📋
占卜	占卜 🔮
站	站 🧍‍♂ 🧍‍♀ 🧍 🧍🏻‍♂ 🧍🏼‍♂ 🧍🏽‍♂ 🧍🏾‍♂ 🧍🏿‍♂ 🧍🏻‍♀ 🧍🏼‍♀ 🧍🏽‍♀ 🧍🏾‍♀ 🧍🏿‍♀ 🧍🏻 🧍🏼 🧍🏽 🧍🏾 🧍🏿 🧍🏻
站立	站立 🧍‍♂ 🧍‍♀ 🧍 🧍🏻‍♂ 🧍🏼‍♂ 🧍🏽‍♂ 🧍🏾‍♂ 🧍🏿‍♂ 🧍🏻‍♀ 🧍🏼‍♀ 🧍🏽‍♀ 🧍🏾‍♀ 🧍🏿‍♀ 🧍🏻 🧍🏼 🧍🏽 🧍🏾 🧍🏿 🧍🏻
张开	张开 👐 👐🏻 👐🏻
张开双手	张开双手 👐 👐🏻 👐🏻
张嘴笑	张嘴笑 😃
章节	章节 §
章鱼	章鱼 🐙
章魚	章魚 🐙
張開	張開 👐 👐🏻 👐🏻
張開雙手	張開雙手 👐 👐🏻 👐🏻
張嘴笑	張嘴笑 😃
长度	长度 ㎙ ㎚ ㎛ ㎜ ㎝ ㎞ ↕ ↕️
长棍面包	长棍面包 🥖
长号	长号 🎺
长货车	长货车 🚛
长颈鹿	长颈鹿 🦒
长裤	长裤 👖
长曲棍球	长曲棍球 🥍
长条图	长条图 📊
长筒靴	长筒靴 👢
长靴	长靴 👢
长者	长者 👴 👨‍🦳 👵 🧓 👴🏻 👴🏼 👴🏽 👴🏾 👴🏿 👨🏻‍🦳 👨🏼‍🦳 👨🏽‍🦳 👨🏾‍🦳 👨🏿‍🦳 👵🏻 👵🏼 👵🏽 👵🏾 👵🏿 🧓🏻 🧓🏼 🧓🏽 🧓🏾 🧓🏿 🧓🏻
涨	涨 🆙 📈 🆙️ 📈
涨势	涨势 📈
掌声	掌声 👏
掌聲	掌聲 👏
掌心	掌心 🤲🏻
掌印	掌印 🐾
漲	漲 🆙 📈 🆙️ 📈
漲勢	漲勢 📈
帐本	帐本 📒
帐簿	帐簿 📒
帐蓬	帐蓬 ⛺ △
帐篷	帐篷 ⛺ △ ⛺️
账本	账本 📒
账簿	账簿 📒
帳本	帳本 📒
帳簿	帳簿 📒
帳蓬	帳蓬 ⛺
帳篷	帳篷 ⛺ ⛺️
賬本	賬本 📒
賬簿	賬簿 📒
招呼	招呼 🙋 🙋🏻‍♀ 🙋🏻‍♂ 🙋🏻
招手	招手 🙋 🙋🏻‍♀ 🙋🏻‍♂ 🙋🏻
昭和	昭和 ㍼
爪	爪 🐾 🫳🏻
爪印	爪印 🐾
找	找 🔍 🔎
找换	找换 💱
找換	找換 💱
找死	找死 😠 😾
照明	照明 🔦
照相	照相 📷 📸 📸
照相机	照相机 📷 📸 📷
照相機	照相機 📷
折	折 乛 乚 亅
这	这 🈁 😥 😿 😢 😥 😿
这边	这边 💁🏻‍♀ 💁🏻‍♂ 💁🏻
这里	这里 🈁 🈁️
這	這 😥 😿 😢 😥 😿
這邊	這邊 💁🏻‍♀ 💁🏻‍♂ 💁🏻
這裏	這裏 🈁 🈁️
着急	着急 😟 😣
着迷	着迷 😍 😻
针	针 💉 💉 🪡
针管	针管 💉
针筒	针筒 💉
侦探	侦探 🕵‍♂ 🕵 🕵‍♀ 🕵🏻‍♂ 🕵🏼‍♂ 🕵🏽‍♂ 🕵🏾‍♂ 🕵🏿‍♂ 🕵🏻 🕵🏼 🕵🏽 🕵🏾 🕵🏿 🕵🏻‍♀ 🕵🏼‍♀ 🕵🏽‍♀ 🕵🏾‍♀ 🕵🏿‍♀ 🕵🏻
真棒	真棒 👍 💯 😺 👍🏻 👍🏻 💯
真的假的	真的假的 😳
真的嗎	真的嗎 😓 😳
真的吗	真的吗 😓 😳
真好	真好 😀 😺 🙆 🙆🏻‍♀ 🙆🏻‍♂ 😀 😺 🙆🏻
真好玩	真好玩 😆
真龙	真龙 🐉
真龍	真龍 🐉
真心	真心 💖
針	針 💉 💉 🪡
針筒	針筒 💉
偵探	偵探 🕵 🕵🏻‍♀ 🕵🏻‍♂ 🕵🏻
阵列	阵列 📡
阵雨	阵雨 🌦 🌦️
陣列	陣列 📡
陣雨	陣雨 🌦 🌦️
振动模式	振动模式 📳
振動模式	振動模式 📳
震	震 ☳
震动	震动 📳 📴
震動	震動 📳
筝	筝 ㉇
蒸馏	蒸馏 ⚗
蒸馏瓶	蒸馏瓶 ⚗ ⚗️
蒸餾瓶	蒸餾瓶 ⚗ ⚗️
蒸气火车	蒸气火车 🚂
蒸汽船	蒸汽船 🚢
蒸汽机车	蒸汽机车 🚂
蒸汽機車	蒸汽機車 🚂
蒸氣火車	蒸氣火車 🚂
蒸桑拿	蒸桑拿 🧖🏻‍♀ 🧖🏻‍♂ 🧖🏻
蒸碗	蒸碗 🍜
正	正 ㊣
正比	正比 ∝
正餐	正餐 🥘 🍜 🍲 🍛 🍝 🍱 🍚 🥗
正方形	正方形 ▪ ▫ ◻ ◼ ◽ ◾ ⬛ ⬜ 🔶 🔷 🔸 🔹 💠 🔲 🔳 🟥 🟧 🟨 🟩 🟦 🟪 🟫
正负	正负 ± ∓
正面的鸡宝宝	正面的鸡宝宝 🐥
正面的雞寶寶	正面的雞寶寶 🐥
正面的小鸡	正面的小鸡 🐥
正面的小鸡宝宝	正面的小鸡宝宝 🐥
正面的小雞	正面的小雞 🐥
正面的小雞寶寶	正面的小雞寶寶 🐥
正确	正确 ✅ ☑ ✓ ✔ ⭕ √ 🙆
正確	正確 ✅ ☑ ✓ ✔ ⭕ √ 🙆
正中红心	正中红心 🎯
正中紅心	正中紅心 🎯
正装	正装 👔
正裝	正裝 👔
证件	证件 🆔 🆔️
证件检查	证件检查 🛂
证书	证书 📄
證件	證件 🆔 🆔️
證件檢查	證件檢查 🛂
證書	證書 📄
枝	枝 🌿
枝条	枝条 🌿
枝條	枝條 🌿
知道了	知道了 😐
知识份子	知识份子 🤓
知識份子	知識份子 🤓
蜘蛛	蜘蛛 🕷 🕷️
蜘蛛网	蜘蛛网 🕸 🕸️
蜘蛛網	蜘蛛網 🕸 🕸️
直布罗陀	直布罗陀 🇬🇮
直布羅陀	直布羅陀 🇬🇮
直尺	直尺 📏
直方图	直方图 📊
直方圖	直方圖 📊
直和	直和 ⊕
直积	直积 ⊗
直接命中	直接命中 🎯
直立	直立 🧍‍♂ 🧍‍♀ 🧍 🧍🏻‍♂ 🧍🏼‍♂ 🧍🏽‍♂ 🧍🏾‍♂ 🧍🏿‍♂ 🧍🏻‍♀ 🧍🏼‍♀ 🧍🏽‍♀ 🧍🏾‍♀ 🧍🏿‍♀ 🧍🏻 🧍🏼 🧍🏽 🧍🏾 🧍🏿
直升机	直升机 🚁
直升機	直升機 🚁
直昇機	直昇機 🚁
直饮水	直饮水 🚰
直飲水	直飲水 🚰
职员	职员 👨‍💼 🧑‍💼 👩‍💼 👨🏻‍💼 👨🏼‍💼 👨🏽‍💼 👨🏾‍💼 👨🏿‍💼 🧑🏻‍💼 🧑🏼‍💼 🧑🏽‍💼 🧑🏾‍💼 🧑🏿‍💼 👩🏻‍💼 👩🏼‍💼 👩🏽‍💼 👩🏾‍💼 👩🏿‍💼 🧑🏻‍💼
植物	植物 🌰 🌱 🌲 🌳 🌴 🌵 🌷 🌸 🌹 🌺 🌻 🌼 🌽 🌾 🌿 🍀 🍁 🍂 🍃 🍄 🎍 🎄 ☘ 🥬 🌲 🌳 🎄 🌵 🌴 🌱 🌿 ☘️ 🍀 🎍 🪴 🌾 🥬
職員	職員 👨🏻‍💼 👩🏻‍💼 🧑🏻‍💼
纸	纸 📃 📜 📄
纸币	纸币 💵 💶 💷 💴
纸牌	纸牌 🃏 🎴
纸箱	纸箱 📦
指	指 🈯 🈯️ 🫵🏻
指定	指定 🈯
指环	指环 💍
指環	指環 💍
指甲油	指甲油 💅 💅🏻 💅🏼 💅🏽 💅🏾 💅🏿
指南针	指南针 🧭
指南針	指南針 🧭
指数	指数 💹
指數	指數 💹
紙幣	紙幣 💵 💶 💷 💴
紙牌	紙牌 🃏 🎴
紙箱	紙箱 📦
至	至 ~ ㉃
豸	豸 🐈
制表	制表 ─ ━ │ ┃ ┄ ┅ ┆ ┇ ┈ ┉ ┊ ┋ ┌ ┍ ┎ ┏ ┐ ┑ ┒ ┓ └ ┕ ┖ ┗ ┘ ┙ ┚ ┛ ├ ┝ ┞ ┟ ┠ ┡ ┢ ┣ ┤ ┥ ┦ ┧ ┨ ┩ ┪ ┫ ┬ ┭ ┮ ┯ ┰ ┱ ┲ ┳ ┴ ┵ ┶ ┷ ┸ ┹ ┻ ┼ ┽ ┾ ┿ ╀ ╁ ╂ ╃ ╄ ╅ ╆ ╇ ╈ ╉ ╊ ╋ ═ ║ ╒ ╓ ╔ ╕ ╖ ╗ ╘ ╙ ╚ ╛ ╜ ╝ ╞ ╟ ╠ ╡ ╢ ╣ ╤ ╥ ╦ ╧ ╨ ╩ ╪ ╫ ╬ ╭ ╮ ╯ ╰ ╱ ╲ ╳
质量	质量 ㎍ ㎎ ㎏
致命	致命 ☠ ☠️
致谢	致谢 🙏
致謝	致謝 🙏
智慧	智慧 😇
智利	智利 🇨🇱
智能机	智能机 📱
智能機	智能機 📱
置顶	置顶 🔝
置頂	置頂 🔝
中	中 ㊥ 🈭 🀄
中标	中标 ， 。 ？ ！ ： ； …… ～ “ ” “” 、 （ ） （） —— ‘ ’ ‘’ · ＠ ＆ ＊ ＃ 《 》 《》 ￥ 〈 〉 〈〉 ＄ ［ ］ ［］ ￡ ｛ ｝ ｛｝ ￠ 【 】 【】 ％ 〖 〗 〖〗 ／ 〔 〕 〔〕 ＼ 『 』 『』 ＾ 「 」 「」 ｜ ﹁ ﹂ ｀ ．
中餐	中餐 🍜 🍚 🍲 🥘 🥟 🥠 🥡 🥢
中产阶级	中产阶级 👨🏻‍💼 👩🏻‍💼
中產階級	中產階級 👨🏻‍💼 👩🏻‍💼
中等白方	中等白方 ◽ ◽️
中等黑方	中等黑方 ◾ ◾️
中方块	中方块 ◽ ◾ ◽️ ◾️
中方塊	中方塊 ◽ ◾ ◽️ ◾️
中非	中非 🇨🇫
中非共和国	中非共和国 🇨🇫
中非共和國	中非共和國 🇨🇫
中国	中国 🇨🇳 中华人民共和国 中華人民共和國
中国大陆	中国大陆 🇨🇳
中国国旗	中国国旗 🇨🇳
中國	中國 🇨🇳
中國大陸	中國大陸 🇨🇳
中华传统	中华传统 🧧 🥮 🧨 🧮
中华民国	中华民国 🇹🇼
中华人民共和国	中华人民共和国 🇨🇳
中华人民共和国国旗	中华人民共和国国旗 🇨🇳
中華傳統	中華傳統 🧧 🥮 🧨 🧮
中華民國	中華民國 🇹🇼
中華人民共和國	中華人民共和國 🇨🇳
中華人民共和國國旗	中華人民共和國國旗 🇨🇳
中秋	中秋 🎑 🌕 🌕 🎑
中秋节	中秋节 🎑 🌕 🌕 🎑
中秋節	中秋節 🌕 🎑
中日韩标点	中日韩标点 〽
中日韓標點	中日韓標點 〽
中式快餐	中式快餐 🍱
中午好	中午好 🙂
中性	中性 🧑‍🦱 🧑‍🦰 👱 🧑‍🦳 🧑‍🦲 🧑🏻‍🦱 🧑🏼‍🦱 🧑🏽‍🦱 🧑🏾‍🦱 🧑🏿‍🦱 🧑🏻‍🦰 🧑🏼‍🦰 🧑🏽‍🦰 🧑🏾‍🦰 🧑🏿‍🦰 👱🏻 👱🏼 👱🏽 👱🏾 👱🏿 🧑🏻‍🦳 🧑🏼‍🦳 🧑🏽‍🦳 🧑🏾‍🦳 🧑🏿‍🦳 🧑🏻‍🦲 🧑🏼‍🦲 🧑🏽‍🦲 🧑🏾‍🦲 🧑🏿‍🦲
中学	中学 🏫
中學	中學 🏫
中药	中药 🌿
中藥	中藥 🌿
中指	中指 🖕 🖕🏻 🖕🏼 🖕🏽 🖕🏾 🖕🏿 🖕🏻
终	终 🈡
终点	终点 🏁 🚩
钟	钟 🕛 🕧 🕐 🕜 🕑 🕝 🕒 🕞 🕓 🕟 🕔 🕠 🕕 🕡 🕖 🕢 🕗 🕣 🕘 🕤 🕙 🕥 🕚 🕦
钟表	钟表 🕛 🕧 🕐 🕜 🕑 🕝 🕒 🕞 🕓 🕟 🕔 🕠 🕕 🕡 🕖 🕢 🕗 🕣 🕘 🕤 🕙 🕥 🕚 🕦
終點	終點 🏁 🚩
螽斯	螽斯 🦗
种地	种地 👨🏻‍🌾 👩🏻‍🌾 🧑🏻‍🌾
种田	种田 👨🏻‍🌾 👩🏻‍🌾 🧑🏻‍🌾
種地	種地 👨🏻‍🌾 👩🏻‍🌾 🧑🏻‍🌾
種田	種田 👨🏻‍🌾 👩🏻‍🌾 🧑🏻‍🌾
仲秋	仲秋 🌕 🎑
重点	重点 ※
重复	重复 々
重金属	重金属 🤘 🤘🏻 🤘🏼 🤘🏽 🤘🏾 🤘🏿
重新播放	重新播放 🔃
重新读取	重新读取 🔃
重新讀取	重新讀取 🔃
重新载入	重新载入 🔃
重新載入	重新載入 🔃
重新整理	重新整理 🔄
重要	重要 ※
重载	重载 🔃
重載	重載 🔃
重做	重做 ↪ ↪️
周二	周二 火曜日 かようび
周六	周六 土曜日 どようび
周日	周日 日曜日 にちようび
周三	周三 水曜日 すいようび
周四	周四 木曜日 もくようび
周天	周天 日曜日 にちようび
周五	周五 金曜日 きんようび
周一	周一 月曜日 げつようび
皱眉	皱眉 🙁 😦 🙍‍♂ 🙍 🙍‍♀ 🙍🏻‍♂ 🙍🏼‍♂ 🙍🏽‍♂ 🙍🏾‍♂ 🙍🏿‍♂ 🙍🏻 🙍🏼 🙍🏽 🙍🏾 🙍🏿 🙍🏻‍♀ 🙍🏼‍♀ 🙍🏽‍♀ 🙍🏾‍♀ 🙍🏿‍♀ ☹ 😠 🙍🏻
皺眉	皺眉 😠 🙍 🙍🏻‍♀ 🙍🏻‍♂ 🙍🏻
骤雨	骤雨 ☔
驟雨	驟雨 ☔
朱古力	朱古力 🍫
朱古力棒	朱古力棒 🍫
朱古力饼	朱古力饼 🍪
朱古力餅	朱古力餅 🍪
朱古力圈	朱古力圈 🍩
珠宝	珠宝 💎
珠寶	珠寶 💎
株	株 ㊑ ㈱
株式会社	株式会社 ㍿
猪	猪 🐷 🐖 🐗 🐽 𓃟 🐖
猪鼻	猪鼻 🐽
猪鼻子	猪鼻子 🐽
猪脸	猪脸 🐷
猪年	猪年 🐷
猪排	猪排 🥩
猪肉	猪肉 🐖
猪头	猪头 🐗 🐷 🐷
猪头三	猪头三 🐷
蛛	蛛 🕷 🕷️
蛛网	蛛网 🕸 🕸️
蛛網	蛛網 🕸 🕸️
豬	豬 🐖 🐗 🐷 🐖
豬鼻	豬鼻 🐽
豬鼻子	豬鼻子 🐽
豬臉	豬臉 🐷
豬年	豬年 🐷
豬排	豬排 🥩
豬肉	豬肉 🐖
豬頭	豬頭 🐗 🐷 🐷
豬頭三	豬頭三 🐷
竹	竹 🀤 🎍
竹节	竹节 🎍
竹節	竹節 🎍
竹篮	竹篮 🧺
竹籃	竹籃 🧺
主厨	主厨 👨🏻‍🍳 👩🏻‍🍳 🧑🏻‍🍳
主廚	主廚 👨🏻‍🍳 👩🏻‍🍳 🧑🏻‍🍳
主意	主意 💭
助听器	助听器 🦻 🦻🏻 🦻🏼 🦻🏽 🦻🏾 🦻🏿 🦻🏻
住店	住店 🛌 🛌🏻
住家	住家 🏠 🏡
住口	住口 🤐 🤭 🙊
住宿	住宿 🛌 🛌🏻
住宅	住宅 🏘 🏚 🏠 🏡 ⌂
住宅楼	住宅楼 🏠
住宅樓	住宅樓 🏠
住宅区	住宅区 🏘 🏘️
住宅區	住宅區 🏘 🏘️
注	注 ㊟
注册	注册 ®
注册商标	注册商标 ® ®️
注目	注目 👁 👁️
注射	注射 💉
注射器	注射器 💉
注视	注视 👁 👁️
注視	注視 👁 👁️
注意	注意 ⚠
注意儿童	注意儿童 🚸
注意兒童	注意兒童 🚸
注意事项	注意事项 📋
注意事項	注意事項 📋
注音	注音 ㄅ ㄆ ㄇ ㄈ ㄉ ㄊ ㄋ ㄌ ㄍ ㄎ ㄏ ㄐ ㄑ ㄒ ㄓ ㄔ ㄕ ㄖ ㄗ ㄘ ㄙ ㄚ ㄛ ㄜ ㄝ ㄞ ㄟ ㄠ ㄡ ㄢ ㄣ ㄤ ㄥ ㄦ ㄧ 丨 ㄨ ㄩ
祝	祝 ㊗ ㈷ ㊗️
祝福	祝福 🙏 🙏🏻 🙏🏼 🙏🏽 🙏🏾 🙏🏿 ㊗
祝贺	祝贺 🥳 🍾 ㊗ 🥳
祝賀	祝賀 ㊗ 🥳 🥳
祝日	祝日 🎌
著火	著火 🔥
著急	著急 😣
著陆	著陆 🛬
著陸	著陸 🛬
著迷	著迷 😍 😻
註冊	註冊 ®
註冊商標	註冊商標 ® ®️
箸	箸 🥢
抓狂	抓狂 🤯
专家	专家 👨🏻‍🔬 👩🏻‍🔬 🧑🏻‍🔬
砖	砖 🧱
砖块	砖块 🧱
砖头	砖头 🧱
專家	專家 👨🏻‍🔬 👩🏻‍🔬 🧑🏻‍🔬
磚	磚 🧱
转上	转上 ⤴ ⤴️
转下	转下 ⤵ ⤵️
转向后方	转向后方 ⤵
转向前方	转向前方 ⤴
轉上	轉上 ⤴ ⤴️
轉下	轉下 ⤵ ⤵️
轉向後方	轉向後方 ⤵
轉向前方	轉向前方 ⤴
装傻	装傻 🤪
状师	状师 👨🏻‍⚖ 👩🏻‍⚖ 🧑🏻‍⚖️
狀師	狀師 👨🏻‍⚖ 👩🏻‍⚖ 🧑🏻‍⚖️
撞击	撞击 💥
撞擊	撞擊 💥
撞球	撞球 🎱
戇居	戇居 🐷
准許	准許 🙆
准确	准确 🎯
准许	准许 🙆
準確	準確 🎯
桌球	桌球 🎱
桌遊	桌遊 🎴
桌遊卡	桌遊卡 🎴
桌游	桌游 🎴
桌游卡	桌游卡 🎴
咨询	咨询 ℹ ℹ️
资	资 ㊮ ㈾
资金	资金 💲
资料	资料 💾 📃 📄
资料夹	资料夹 📁
资讯	资讯 ℹ ℹ️
資金	資金 💲
資料	資料 💾 📃 📄
資料夾	資料夾 📁
資訊	資訊 ℹ ℹ️
諮詢	諮詢 ℹ ℹ️
子弹列车	子弹列车 🚅
子弹头	子弹头 🚄 🚅 🚅
子彈列車	子彈列車 🚅
子彈頭	子彈頭 🚄 🚅 🚅
子午线	子午线 🌐
子午線	子午線 🌐
姊弟	姊弟 👫 👫🏻
姊妹	姊妹 👭 👭🏻
紫荆花旗	紫荆花旗 🇭🇰
紫荊花旗	紫荊花旗 🇭🇰
紫色心形	紫色心形 💜
紫心	紫心 💜
自	自 ㉂
自动柜员机	自动柜员机 🏧
自動櫃員機	自動櫃員機 🏧
自行车	自行车 🚲
自行车手	自行车手 🚴
自行車	自行車 🚲
自行車手	自行車手 🚴
自拍	自拍 🤳 🤳🏻 🤳🏼 🤳🏽 🤳🏾 🤳🏿 🤳🏻
自然	自然 🌃 🌄 🌅 🌆 🌇 🌈 🌉 🌋 🌌 🌊 🔥 💧 🌬 ☀ 🌤 ⛅ 🌦 🌥 ☁ 🌨 🌧 🌩 ⛈ ❄ 💨 🌪 🌫 🔥 💧 🌬 🫧 ☀️ 🌤 ⛅ 🌦 🌥 ☁️ 🌨 🌧 🌩 ⛈ ❄️ 💨 🌪 🌫 🌊 🧊 🪨
自然风光	自然风光 🏞 🏞️
自然風光	自然風光 🏞 🏞️
自信	自信 😼
自由	自由 🆓
自由女神	自由女神 🗽
自由泳	自由泳 🏊 🏊🏻‍♀ 🏊🏻‍♂ 🏊🏻
字	字 🈑
字节	字节 ㎅ ㎆ ㎇
字母	字母 🔤
宗	宗 ㊪
宗教	宗教 🕉 ✡ ☸ ✝ ☦ ☪ ☮ 🕎 🔯 ☯ 🛐 ⛪ 🕌 🕍 🕋 ⛩ ✝️ ☪️ 🕉 ☸️ 🔯 🕎 ☯️ ☦️ 🛐 ⛪ 🕌 🕍 🕋 ⛩ 🛕
棕榈	棕榈 🌴
棕榈树	棕榈树 🌴
棕櫚	棕櫚 🌴
棕櫚樹	棕櫚樹 🌴
棕色人种	棕色人种 👨🏽 👩🏽 👴🏽 👵🏽 👦🏽 👧🏽 👶🏽 🧓🏽 🧑🏽 🧒🏽 👶🏽
棕色人種	棕色人種 👨🏽 👩🏽 👴🏽 👵🏽 👦🏽 👧🏽 👶🏽 🧓🏽 🧑🏽 🧒🏽 👶🏽
棕熊	棕熊 🐻
踪迹	踪迹 🐾
蹤跡	蹤跡 🐾
走	走 🚶‍♂ 🚶‍ 🚶‍♀ 🚶🏻‍♂ 🚶🏼‍♂ 🚶🏽‍♂ 🚶🏾‍♂ 🚶🏿‍♂ 🚶🏻 🚶🏼 🚶🏽 🚶🏾 🚶🏿 🚶🏻‍♀ 🚶🏼‍♀ 🚶🏽‍♀ 🚶🏾‍♀ 🚶🏿‍♀ 🈰 🚶 🚶🏻
足	足 🦶🏻
足迹	足迹 🐾 👣
足跡	足跡 🐾 👣
足球	足球 ⚽ ⚽️
足印	足印 🐾 👣
祖父	祖父 👴 👴🏻 👴🏻
祖母	祖母 👵 👵🏻 👵🏻
钻戒	钻戒 💍
钻石	钻石 💎
鑽戒	鑽戒 💍
鑽石	鑽石 💎
嘴	嘴 👄
嘴巴	嘴巴 👄
嘴馋	嘴馋 😋
嘴饞	嘴饞 😋
嘴唇	嘴唇 👄
嘴角上扬	嘴角上扬 😏
嘴角上揚	嘴角上揚 😏
醉	醉 🥴
樽	樽 🏺
左	左 ㊧ ⬅ 🈬 ← ⇐ ⇦ ⇠ ⇇ ⬅️ 🫲🏻
左边	左边 👈 👈🏻 👈🏻 🫲🏻
左邊	左邊 👈 👈🏻 👈🏻 🫲🏻
左勾拳	左勾拳 🤜🏻
左回转	左回转 ↩
左迴轉	左迴轉 ↩
左轮枪	左轮枪 🔫
左輪槍	左輪槍 🔫
左拳	左拳 🤜🏻
左上	左上 ↖ ↖️
左上箭头	左上箭头 ↖
左上箭頭	左上箭頭 ↖
左手边	左手边 👈 👈🏻 👈🏻
左手邊	左手邊 👈 👈🏻 👈🏻
左下	左下 ↙ ↙️
左下箭头	左下箭头 ↙
左下箭頭	左下箭頭 ↙
左右	左右 ↔
左右箭头	左右箭头 ↔
左右箭頭	左右箭頭 ↔
左转	左转 ⬅
左轉	左轉 ⬅
作弄	作弄 😜
作曲	作曲 🎼
坐车	坐车 🚙
坐車	坐車 🚙
座机	座机 ☎ ☎️
座機	座機 ☎ ☎️
座位	座位 💺
座椅	座椅 💺
座钟	座钟 🕰
做饭	做饭 🍳
做鬼脸	做鬼脸 😜
做鬼臉	做鬼臉 😜
做礼拜	做礼拜 ⛪ 🛐 🛐
做禮拜	做禮拜 ⛪ 🛐 🛐
做实验	做实验 🔬
做實驗	做實驗 🔬
做运动	做运动 ⛷ 🏂 🏋🏻 🤺 🤼 🤸🏻 ⛹🏻 🤾🏻 🏌🏻 🏄🏻 🏊🏻 🤽🏻 🚣🏻 🏇🏻 🚴🏻 🚵🏻 🧗🏻 🤹🏻 ⛷ 🏂🏻 🏋🏻 🤺 🤼🏻 🤸🏻 ⛹🏻 🤾🏻 🏌🏻 🏄🏻 🏊🏻 🤽🏻 🚣🏻 🏇🏻 🚴🏻 🚵🏻 🧗🏻 🤹🏻
做运动男	做运动男 ⛷ 🏂 🏋🏻‍♂ 🤺 🤼‍♂ 🤸🏻‍♂ ⛹🏻‍♂ 🤾🏻‍♂ 🏌🏻‍♂ 🏄🏻‍♂ 🏊🏻‍♂ 🤽🏻‍♂ 🚣🏻‍♂ 🏇🏻 🚴🏻‍♂ 🚵🏻‍♂ 🧗🏻‍♂ 🤹🏻‍♂ ⛷ 🏂🏻 🏋🏻‍♂️ 🤺 🤼🏻‍♂️ 🤸🏻‍♂️ ⛹🏻‍♂️ 🤾🏻‍♂️ 🏌🏻‍♂️ 🏄🏻‍♂️ 🏊🏻‍♂️ 🤽🏻‍♂️ 🚣🏻‍♂️ 🏇🏻 🚴🏻‍♂️ 🚵🏻‍♂️ 🧗🏻‍♂️ 🤹🏻‍♂️
做运动女	做运动女 ⛷ 🏂 🏋🏻‍♀ 🤺 🤼‍♀ 🤸🏻‍♀ ⛹🏻‍♀ 🤾🏻‍♀ 🏌🏻‍♀ 🏄🏻‍♀ 🏊🏻‍♀ 🤽🏻‍♀ 🚣🏻‍♀ 🏇🏻 🚴🏻‍♀ 🚵🏻‍♀ 🧗🏻‍♀ 🤹🏻‍♀ ⛷ 🏂🏻 🏋🏻‍♀️ 🤺 🤼🏻‍♀️ 🤸🏻‍♀️ ⛹🏻‍♀️ 🤾🏻‍♀️ 🏌🏻‍♀️ 🏄🏻‍♀️ 🏊🏻‍♀️ 🤽🏻‍♀️ 🚣🏻‍♀️ 🏇🏻 🚴🏻‍♀️ 🚵🏻‍♀️ 🧗🏻‍♀️ 🤹🏻‍♀️
做運動	做運動 ⛷ 🏂 🏋🏻 🤺 🤼 🤸🏻 ⛹🏻 🤾🏻 🏌🏻 🏄🏻 🏊🏻 🤽🏻 🚣🏻 🏇🏻 🚴🏻 🚵🏻 🧗🏻 🤹🏻 ⛷ 🏂🏻 🏋🏻 🤺 🤼🏻 🤸🏻 ⛹🏻 🤾🏻 🏌🏻 🏄🏻 🏊🏻 🤽🏻 🚣🏻 🏇🏻 🚴🏻 🚵🏻 🧗🏻 🤹🏻
做運動男	做運動男 ⛷ 🏂 🏋🏻‍♂ 🤺 🤼‍♂ 🤸🏻‍♂ ⛹🏻‍♂ 🤾🏻‍♂ 🏌🏻‍♂ 🏄🏻‍♂ 🏊🏻‍♂ 🤽🏻‍♂ 🚣🏻‍♂ 🏇🏻 🚴🏻‍♂ 🚵🏻‍♂ 🧗🏻‍♂ 🤹🏻‍♂ ⛷ 🏂🏻 🏋🏻‍♂️ 🤺 🤼🏻‍♂️ 🤸🏻‍♂️ ⛹🏻‍♂️ 🤾🏻‍♂️ 🏌🏻‍♂️ 🏄🏻‍♂️ 🏊🏻‍♂️ 🤽🏻‍♂️ 🚣🏻‍♂️ 🏇🏻 🚴🏻‍♂️ 🚵🏻‍♂️ 🧗🏻‍♂️ 🤹🏻‍♂️
做運動女	做運動女 ⛷ 🏂 🏋🏻‍♀ 🤺 🤼‍♀ 🤸🏻‍♀ ⛹🏻‍♀ 🤾🏻‍♀ 🏌🏻‍♀ 🏄🏻‍♀ 🏊🏻‍♀ 🤽🏻‍♀ 🚣🏻‍♀ 🏇🏻 🚴🏻‍♀ 🚵🏻‍♀ 🧗🏻‍♀ 🤹🏻‍♀ ⛷ 🏂🏻 🏋🏻‍♀️ 🤺 🤼🏻‍♀️ 🤸🏻‍♀️ ⛹🏻‍♀️ 🤾🏻‍♀️ 🏌🏻‍♀️ 🏄🏻‍♀️ 🏊🏻‍♀️ 🤽🏻‍♀️ 🚣🏻‍♀️ 🏇🏻 🚴🏻‍♀️ 🚵🏻‍♀️ 🧗🏻‍♀️ 🤹🏻‍♀️
酢浆草	酢浆草 ☘ ☘️
酢漿草	酢漿草 ☘ ☘️
𪠳	𪠳 😏 😝 🤪 🤪
𪡃	𪡃 😟
𫙠	𫙠 🐬
东亚人	东亚人 🧓🏻 🧑🏻 🧒🏻 👶🏻
东亚人女	东亚人女 👵🏻 👩🏻 👧🏻
东亚人男	东亚人男 👴🏻 👨🏻 👦🏻
中华	中华 🧧 🥮 🧨 🧮
中華	中華 🧧 🥮 🧨 🧮
亚裔女	亚裔女 👵🏻 👩🏻 👧🏻
亚裔男	亚裔男 👴🏻 👨🏻 👦🏻
亞裔女	亞裔女 👵🏻 👩🏻 👧🏻
亞裔男	亞裔男 👴🏻 👨🏻 👦🏻
圆型	圆型 🔴 🟠 🟡 🟢 🔵 🟣 🟤 ⚫️ ⚪️
圓型	圓型 🔴 🟠 🟡 🟢 🔵 🟣 🟤 ⚫️ ⚪️
心型	心型 ❤️ 🧡 💛 💚 💙 💜 🤎 🖤 🤍
拉丁裔女	拉丁裔女 👵🏽 👩🏽 👧🏽
拉丁裔男	拉丁裔男 👴🏽 👨🏽 👦🏽
拉美人	拉美人 🧓🏽 🧑🏽 🧒🏽 👶🏽
拉美人女	拉美人女 👵🏽 👩🏽 👧🏽
拉美人男	拉美人男 👴🏽 👨🏽 👦🏽
拉美裔女	拉美裔女 👵🏽 👩🏽 👧🏽
拉美裔男	拉美裔男 👴🏽 👨🏽 👦🏽
方型	方型 🟥 🟧 🟨 🟩 🟦 🟪 🟫 ⬛️ ⬜️
时钟	时钟 🕛 🕧 🕐 🕜 🕑 🕝 🕒 🕞 🕓 🕟 🕔 🕠 🕕 🕡 🕖 🕢 🕗 🕣 🕘 🕤 🕙 🕥 🕚 🕦
時鐘	時鐘 🕛 🕧 🕐 🕜 🕑 🕝 🕒 🕞 🕓 🕟 🕔 🕠 🕕 🕡 🕖 🕢 🕗 🕣 🕘 🕤 🕙 🕥 🕚 🕦
服飾	服飾 🧥 👚 👕 👖 🩳 👔 👗 👘 🥻 🩲 👙 🩱 🥼
服饰	服饰 🧥 👚 👕 👖 🩳 👔 👗 👘 🥻 🩲 👙 🩱 🥼
東亞人	東亞人 🧓🏻 🧑🏻 🧒🏻 👶🏻
東亞人女	東亞人女 👵🏻 👩🏻 👧🏻
東亞人男	東亞人男 👴🏻 👨🏻 👦🏻
棕色人种女	棕色人种女 👵🏽 👩🏽 👧🏽
棕色人种男	棕色人种男 👴🏽 👨🏽 👦🏽
棕色人種女	棕色人種女 👵🏽 👩🏽 👧🏽
棕色人種男	棕色人種男 👴🏽 👨🏽 👦🏽
气象	气象 ☀️ 🌤 ⛅ 🌦 🌥 ☁️ 🌨 🌧 🌩 ⛈ ❄️ 💨 🌪 🌫 🌊
氣象	氣象 ☀️ 🌤 ⛅ 🌦 🌥 ☁️ 🌨 🌧 🌩 ⛈ ❄️ 💨 🌪 🌫 🌊
白人女	白人女 👵🏼 👩🏼 👱🏼‍♀️ 👧🏼
白人男	白人男 👴🏼 👨🏼 👱🏼‍♂️ 👦🏼
白种人女	白种人女 👵🏼 👩🏼 👱🏼‍♀️ 👧🏼
白种人男	白种人男 👴🏼 👨🏼 👱🏼‍♂️ 👦🏼
白種人女	白種人女 👵🏼 👩🏼 👱🏼‍♀️ 👧🏼
白種人男	白種人男 👴🏼 👨🏼 👱🏼‍♂️ 👦🏼
穆斯林女	穆斯林女 👳🏽‍♀️ 🧕🏽
穆斯林男	穆斯林男 👳🏽‍♂️ 🧔🏽
精怪女	精怪女 🧙🏻‍♀️ 🧝🏻‍♀️ 🧛🏻‍♀️ 🧟‍♀️ 🧞‍♀️ 🧜🏻‍♀️ 🧚🏻‍♀️ 🦹🏻‍♀️
精怪男	精怪男 🧙🏻‍♂️ 🧝🏻‍♂️ 🧛🏻‍♂️ 🧟‍♂️ 🧞‍♂️ 🧜🏻‍♂️ 🧚🏻‍♂️ 🦹🏻‍♂️
野味	野味 🦉 🦇 🐍 🐢 🦝 🦨 🦡 🦫 🐿 🦦 🦥 🦔 🐺 🐗 🐡 🐬 🐳 🐋 🦈 🦭 🐊 🐅 🐆 🦓 🦍 🦧 🐘 🦛 🦏 🦒 🦘 🦩
野生动物	野生动物 🦉 🦇 🐍 🐢 🦝 🦨 🦡 🦫 🐿 🦦 🦥 🦔 🐺 🐗 🐡 🐬 🐳 🐋 🦈 🦭 🐊 🐅 🐆 🦓 🦍 🦧 🐘 🦛 🦏 🦒 🦘 🦩
野生動物	野生動物 🦉 🦇 🐍 🐢 🦝 🦨 🦡 🦫 🐿 🦦 🦥 🦔 🐺 🐗 🐡 🐬 🐳 🐋 🦈 🦭 🐊 🐅 🐆 🦓 🦍 🦧 🐘 🦛 🦏 🦒 🦘 🦩
阿拉伯人	阿拉伯人 👳🏽
阿拉伯人女	阿拉伯人女 👳🏽‍♀️ 🧕🏽
阿拉伯人男	阿拉伯人男 👳🏽‍♂️ 🧔🏽
顏色	顏色 🟥 🟧 🟨 🟩 🟦 🟪 🟫 ⬛️ ⬜️ 🔴 🟠 🟡 🟢 🔵 🟣 🟤 ⚫️ ⚪️ ❤️ 🧡 💛 💚 💙 💜 🤎 🖤 🤍
颜色	颜色 🟥 🟧 🟨 🟩 🟦 🟪 🟫 ⬛️ ⬜️ 🔴 🟠 🟡 🟢 🔵 🟣 🟤 ⚫️ ⚪️ ❤️ 🧡 💛 💚 💙 💜 🤎 🖤 🤍
黃種人女	黃種人女 👵🏻 👩🏻 👧🏻
黃種人男	黃種人男 👴🏻 👨🏻 👦🏻
黄种人女	黄种人女 👵🏻 👩🏻 👧🏻
黄种人男	黄种人男 👴🏻 👨🏻 👦🏻
黑人女	黑人女 👵🏿 👩🏿 👧🏿
黑人男	黑人男 👴🏿 👨🏿 👦🏿
ID	ID 🪪
K歌	K歌 🪩
㖿	㖿 ✌🏻️
㞎㞎	㞎㞎 💩
㡌	㡌 🧢
㡌子	㡌子 🧢
䢂	䢂 🛗
一定女	一定女 🙆🏻‍♀️
一定男	一定男 🙆🏻‍♂️
一小撮	一小撮 🤌🏻
一撮	一撮 🤌🏻
一点点	一点点 🤌🏻
一點點	一點點 🤌🏻
一齊	一齊 🧑🏻‍🤝‍🧑🏻
一齐	一齐 🧑🏻‍🤝‍🧑🏻
丈夫	丈夫 🤵🏻‍♂️
三分裤	三分裤 🩳
三分褲	三分褲 🩳
三輪車	三輪車 🛺
三轮车	三轮车 🛺
上課女	上課女 👩🏻‍🏫
上課男	上課男 👨🏻‍🏫
上课女	上课女 👩🏻‍🏫
上课男	上课男 👨🏻‍🏫
下跪女	下跪女 🧎🏻‍♀️
下跪男	下跪男 🧎🏻‍♂️
不关我事女	不关我事女 🤷🏻‍♀️
不关我事男	不关我事男 🤷🏻‍♂️
不女	不女 🙅🏻‍♀️
不好女	不好女 🙅🏻‍♀️
不好男	不好男 🙅🏻‍♂️
不干女	不干女 🙅🏻‍♀️
不干男	不干男 🙅🏻‍♂️
不幹女	不幹女 🙅🏻‍♀️
不幹男	不幹男 🙅🏻‍♂️
不男	不男 🙅🏻‍♂️
不知道女	不知道女 🤷🏻‍♀️
不知道男	不知道男 🤷🏻‍♂️
不管女	不管女 🤷🏻‍♀️
不管男	不管男 🤷🏻‍♂️
不行女	不行女 🙅🏻‍♀️
不行男	不行男 🙅🏻‍♂️
不關我事女	不關我事女 🤷🏻‍♀️
不關我事男	不關我事男 🤷🏻‍♂️
专家女	专家女 👩🏻‍🔬
专家男	专家男 👨🏻‍🔬
並肩	並肩 🧑🏻‍🤝‍🧑🏻
中产	中产 🧑🏻‍💼
中产女	中产女 👩🏻‍💼
中产男	中产男 👨🏻‍💼
中產	中產 🧑🏻‍💼
中產女	中產女 👩🏻‍💼
中產男	中產男 👨🏻‍💼
主厨女	主厨女 👩🏻‍🍳
主厨男	主厨男 👨🏻‍🍳
主廚女	主廚女 👩🏻‍🍳
主廚男	主廚男 👨🏻‍🍳
举重女	举重女 🏋🏻‍♀️
举重男	举重男 🏋🏻‍♂️
五弦琴	五弦琴 🪕
亮蛋女	亮蛋女 👩🏻‍🦲
亮蛋男	亮蛋男 👨🏻‍🦲
人魚女	人魚女 🧜🏻‍♀️
人魚男	人魚男 🧜🏻‍♂️
人鱼女	人鱼女 🧜🏻‍♀️
人鱼男	人鱼男 🧜🏻‍♂️
仙人女	仙人女 🧚🏻‍♀️
仙人男	仙人男 🧚🏻‍♂️
企女	企女 🧍🏻‍♀️
企男	企男 🧍🏻‍♂️
体操女	体操女 🤸🏻‍♀️
体操男	体操男 🤸🏻‍♂️
你	你 🫵🏻
侦探女	侦探女 🕵🏻‍♀️
侦探男	侦探男 🕵🏻‍♂️
假肢	假肢 🦾 🦿
偵探女	偵探女 🕵🏻‍♀️
偵探男	偵探男 🕵🏻‍♂️
偷瞄	偷瞄 🫣
偷窥	偷窥 🫣
偷窺	偷窺 🫣
僞裝	僞裝 🥸
僵尸女	僵尸女 🧟‍♀️
僵尸男	僵尸男 🧟‍♂️
兄妹	兄妹 👫🏻
兄弟姐妹	兄弟姐妹 👫🏻
充電	充電 🔋
光头女	光头女 👩🏻‍🦲
光头男	光头男 👨🏻‍🦲
光环	光环 🪐
光環	光環 🪐
光頭女	光頭女 👩🏻‍🦲
光頭男	光頭男 👨🏻‍🦲
內褲	內褲 🩲
冒泡	冒泡 🫧
农户女	农户女 👩🏻‍🌾
农户男	农户男 👨🏻‍🌾
农民女	农民女 👩🏻‍🌾
农民工女	农民工女 👷🏻‍♀️
农民工男	农民工男 👷🏻‍♂️
农民男	农民男 👨🏻‍🌾
冥想	冥想 🧘🏻
冥想女	冥想女 🧘🏻‍♀️
冥想男	冥想男 🧘🏻‍♂️
冰塊	冰塊 🧊
冰壺	冰壺 🥌
冲浪女	冲浪女 🏄🏻‍♀️
冲浪男	冲浪男 🏄🏻‍♂️
划船女	划船女 🚣🏻‍♀️
划船男	划船男 🚣🏻‍♂️
划艇女	划艇女 🚣🏻‍♀️
划艇男	划艇男 🚣🏻‍♂️
別說話	別說話 🫢
别说话	别说话 🫢
刮胡刀	刮胡刀 🪒
刮鬍刀	刮鬍刀 🪒
剃头女	剃头女 💇🏻‍♀️
剃头男	剃头男 💇🏻‍♂️
剃頭女	剃頭女 💇🏻‍♀️
剃頭男	剃頭男 💇🏻‍♂️
剃鬚刀	剃鬚刀 🪒
剪发女	剪发女 💇🏻‍♀️
剪发男	剪发男 💇🏻‍♂️
剪头发女	剪头发女 💇🏻‍♀️
剪头发男	剪头发男 💇🏻‍♂️
剪頭髮女	剪頭髮女 💇🏻‍♀️
剪頭髮男	剪頭髮男 💇🏻‍♂️
剪髮女	剪髮女 💇🏻‍♀️
剪髮男	剪髮男 💇🏻‍♂️
創可貼	創可貼 🩹
加冕	加冕 🫅🏻
加冕女	加冕女 🤴🏻
加冕男	加冕男 👸🏻
助聽器	助聽器 🦻🏻
劳工女	劳工女 👩🏻‍🏭
劳工男	劳工男 👨🏻‍🏭
勞工女	勞工女 👩🏻‍🏭
勞工男	勞工男 👨🏻‍🏭
北极熊	北极熊 🐻‍❄️
北極熊	北極熊 🐻‍❄️
医生女	医生女 👩🏻‍⚕️
医生男	医生男 👨🏻‍⚕️
医者女	医者女 👩🏻‍⚕️
医者男	医者男 👨🏻‍⚕️
半兽人	半兽人 🧌
半獸人	半獸人 🧌
华夫	华夫 🧇
华夫饼	华夫饼 🧇
卖艺女	卖艺女 🤹🏻‍♀️
卖艺男	卖艺男 🤹🏻‍♂️
博士女	博士女 👩🏻‍🎓
博士男	博士男 👨🏻‍🎓
卫士女	卫士女 💂🏻‍♀️
卫士男	卫士男 💂🏻‍♂️
卫门女	卫门女 💂🏻‍♀️
卫门男	卫门男 💂🏻‍♂️
印度寺庙	印度寺庙 🛕
印度寺廟	印度寺廟 🛕
印度庙	印度庙 🛕
印度廟	印度廟 🛕
印度神庙	印度神庙 🛕
印度神廟	印度神廟 🛕
卷发女	卷发女 👩🏻‍🦱
卷发男	卷发男 👨🏻‍🦱
厕所泵	厕所泵 🪠
厨子女	厨子女 👩🏻‍🍳
厨子男	厨子男 👨🏻‍🍳
厨师女	厨师女 👩🏻‍🍳
厨师男	厨师男 👨🏻‍🍳
参禅女	参禅女 🧘🏻‍♀️
参禅男	参禅男 🧘🏻‍♂️
參禪女	參禪女 🧘🏻‍♀️
參禪男	參禪男 🧘🏻‍♂️
双板	双板 ⛷️
双板滑雪	双板滑雪 ⛷️
可惜	可惜 😮‍💨
右面	右面 🫱🏻
合什	合什 🙏🏻
同学	同学 🧑🏻‍🎓
同学女	同学女 👩🏻‍🎓
同学男	同学男 👨🏻‍🎓
同學	同學 🧑🏻‍🎓
同學女	同學女 👩🏻‍🎓
同學男	同學男 👨🏻‍🎓
听不见女	听不见女 🧏🏻‍♀️
听不见男	听不见男 🧏🏻‍♂️
吸把	吸把 🪠
吸血鬼女	吸血鬼女 🧛🏻‍♀️
吸血鬼男	吸血鬼男 🧛🏻‍♂️
咬唇	咬唇 🫦
哈哈	哈哈 😄 😸 🤭
哎	哎 😮‍💨
唔关我事女	唔关我事女 🤷🏻‍♀️
唔关我事男	唔关我事男 🤷🏻‍♂️
唔知女	唔知女 🤷🏻‍♀️
唔知男	唔知男 🤷🏻‍♂️
唔關我事女	唔關我事女 🤷🏻‍♀️
唔關我事男	唔關我事男 🤷🏻‍♂️
唱K	唱K 🪩
啦啦队女	啦啦队女 👯🏻‍♀️
啦啦队男	啦啦队男 👯🏻‍♂️
啦啦隊女	啦啦隊女 👯🏻‍♀️
啦啦隊男	啦啦隊男 👯🏻‍♂️
喂奶女	喂奶女 👩🏻‍🍼
喂奶男	喂奶男 👨🏻‍🍼
喜馬紅	喜馬紅 🧉
喜马红	喜马红 🧉
嗯哼	嗯哼 🫤
噘嘴女	噘嘴女 🙎🏻‍♀️
噘嘴男	噘嘴男 🙎🏻‍♂️
回力镖	回力镖 🪃
圣诞奶奶	圣诞奶奶 🤶🏻
圣诞老奶奶	圣诞老奶奶 🤶🏻
坏蛋女	坏蛋女 🦹🏻‍♀️
坏蛋男	坏蛋男 🦹🏻‍♂️
坚强	坚强 🥲
坟地	坟地 🪦
坟墓	坟墓 🪦
堅強	堅強 🥲
墓	墓 🪦
墨西哥粽	墨西哥粽 🫔
墨西哥糉	墨西哥糉 🫔
墳地	墳地 🪦
墳墓	墳墓 🪦
壞蛋女	壞蛋女 🦹🏻‍♀️
壞蛋男	壞蛋男 🦹🏻‍♂️
壶	壶 🫖
壺	壺 🫖
夜总会	夜总会 🪩
夜總會	夜總會 🪩
大厨女	大厨女 👩🏻‍🍳
大厨男	大厨男 👨🏻‍🍳
大学生女	大学生女 👩🏻‍🎓
大学生男	大学生男 👨🏻‍🎓
大學生女	大學生女 👩🏻‍🎓
大學生男	大學生男 👨🏻‍🎓
大廚女	大廚女 👩🏻‍🍳
大廚男	大廚男 👨🏻‍🍳
大法官女	大法官女 👩🏻‍⚖️
大法官男	大法官男 👨🏻‍⚖️
大状女	大状女 👩🏻‍⚖️
大状男	大状男 👨🏻‍⚖️
大狀女	大狀女 👩🏻‍⚖️
大狀男	大狀男 👨🏻‍⚖️
大肚子女	大肚子女 🤰🏻
大肚子男	大肚子男 🫃🏻
大胡子	大胡子 🧔🏻
大胡子女	大胡子女 🧔🏻‍♀️
大胡子男	大胡子男 🧔🏻‍♂️
大餅	大餅 🫓
大饼	大饼 🫓
大鬍子	大鬍子 🧔🏻
大鬍子女	大鬍子女 🧔🏻‍♀️
大鬍子男	大鬍子男 🧔🏻‍♂️
大麻烦女	大麻烦女 🤦🏻‍♀️
大麻烦男	大麻烦男 🤦🏻‍♂️
大麻煩女	大麻煩女 🤦🏻‍♀️
大麻煩男	大麻煩男 🤦🏻‍♂️
太好了女	太好了女 🙆🏻‍♀️
太好了男	太好了男 🙆🏻‍♂️
太热	太热 🫠
太熱	太熱 🫠
太空人女	太空人女 👩🏻‍🚀
太空人男	太空人男 👨🏻‍🚀
太阳㡌	太阳㡌 🧢
太陽㡌	太陽㡌 🧢
头大女	头大女 🤦🏻‍♀️
头大男	头大男 🤦🏻‍♂️
头巾女	头巾女 👳🏾‍♀️
头巾男	头巾男 👳🏾‍♂️
头疼女	头疼女 🤦🏻‍♀️
头疼男	头疼男 🤦🏻‍♂️
奔跑女	奔跑女 🏃🏻‍♀️
奔跑男	奔跑男 🏃🏻‍♂️
奶酪火鍋	奶酪火鍋 🫕
好㖿	好㖿 😁
好奇	好奇 🤔
好热	好热 🫠
好熱	好熱 🫠
妊娠女	妊娠女 🤰🏻
妊娠男	妊娠男 🫃🏻
妻	妻 👰🏻‍♀️
妻子	妻子 👰🏻‍♀️
委屈女	委屈女 🙎🏻‍♀️
委屈男	委屈男 🙎🏻‍♂️
婚紗	婚紗 👰🏻 👰🏻‍♀️
婚紗男	婚紗男 👰🏻‍♂️
婚纱	婚纱 👰🏻 👰🏻‍♀️
婚纱男	婚纱男 👰🏻‍♂️
学士女	学士女 👩🏻‍🎓
学士男	学士男 👨🏻‍🎓
学生女	学生女 👩🏻‍🎓
学生男	学生男 👨🏻‍🎓
學士女	學士女 👩🏻‍🎓
學士男	學士男 👨🏻‍🎓
學生女	學生女 👩🏻‍🎓
學生男	學生男 👨🏻‍🎓
宇航员女	宇航员女 👩🏻‍🚀
宇航员男	宇航员男 👨🏻‍🚀
宇航員女	宇航員女 👩🏻‍🚀
宇航員男	宇航員男 👨🏻‍🚀
守卫女	守卫女 💂🏻‍♀️
守卫男	守卫男 💂🏻‍♂️
守衛女	守衛女 💂🏻‍♀️
守衛男	守衛男 💂🏻‍♂️
宠物犬	宠物犬 🐕‍🦺
宠物狗	宠物狗 🐕‍🦺
寵物犬	寵物犬 🐕‍🦺
寵物狗	寵物狗 🐕‍🦺
导盲杖	导盲杖 🦯
專家女	專家女 👩🏻‍🔬
專家男	專家男 👨🏻‍🔬
導盲杖	導盲杖 🦯
導盲犬	導盲犬 🦮
小強	小強 🪳
少許	少許 🤌🏻
少许	少许 🤌🏻
山地单车女	山地单车女 🚵🏻‍♀️
山地单车男	山地单车男 🚵🏻‍♂️
山地單車女	山地單車女 🚵🏻‍♀️
山地單車男	山地單車男 🚵🏻‍♂️
山地自行車女	山地自行車女 🚵🏻‍♀️
山地自行車男	山地自行車男 🚵🏻‍♂️
山地自行车女	山地自行车女 🚵🏻‍♀️
山地自行车男	山地自行车男 🚵🏻‍♂️
山地車女	山地車女 🚵🏻‍♀️
山地車男	山地車男 🚵🏻‍♂️
山地车女	山地车女 🚵🏻‍♀️
山地车男	山地车男 🚵🏻‍♂️
山地騎行女	山地騎行女 🚵🏻‍♀️
山地騎行男	山地騎行男 🚵🏻‍♂️
山地骑行女	山地骑行女 🚵🏻‍♀️
山地骑行男	山地骑行男 🚵🏻‍♂️
崇拜女	崇拜女 🙇🏻‍♀️
崇拜男	崇拜男 🙇🏻‍♂️
巢	巢 🪹 🪺
工人女	工人女 👩🏻‍🏭 👷🏻‍♀️
工人男	工人男 👨🏻‍🏭 👷🏻‍♂️
工程师女	工程师女 👩🏻‍💻 👷🏻‍♀️
工程师男	工程师男 👨🏻‍💻 👷🏻‍♂️
工程師女	工程師女 👩🏻‍💻 👷🏻‍♀️
工程師男	工程師男 👨🏻‍💻 👷🏻‍♂️
工薪阶层女	工薪阶层女 👩🏻‍💼
工薪阶层男	工薪阶层男 👨🏻‍💼
工薪階層女	工薪階層女 👩🏻‍💼
工薪階層男	工薪階層男 👨🏻‍💼
左面	左面 🫲🏻
差人女	差人女 👮🏻‍♀️
差人男	差人男 👮🏻‍♂️
巴拉圭茶	巴拉圭茶 🧉
巴西茶	巴西茶 🧉
帚	帚 🧹
并肩	并肩 🧑🏻‍🤝‍🧑🏻
幼虫	幼虫 🐛
幼蟲	幼蟲 🐛
廁所泵	廁所泵 🪠
廚子女	廚子女 👩🏻‍🍳
廚子男	廚子男 👨🏻‍🍳
廚師女	廚師女 👩🏻‍🍳
廚師男	廚師男 👨🏻‍🍳
建筑工人女	建筑工人女 👷🏻‍♀️
建筑工人男	建筑工人男 👷🏻‍♂️
建筑工女	建筑工女 👷🏻‍♀️
建筑工男	建筑工男 👷🏻‍♂️
建築工人女	建築工人女 👷🏻‍♀️
建築工人男	建築工人男 👷🏻‍♂️
建築工女	建築工女 👷🏻‍♀️
建築工男	建築工男 👷🏻‍♂️
律师女	律师女 👩🏻‍⚖️
律师男	律师男 👨🏻‍⚖️
律師女	律師女 👩🏻‍⚖️
律師男	律師男 👨🏻‍⚖️
循环播放	循环播放 🔁
心疼	心疼 ❤️‍🩹
心痛	心痛 ❤️‍🩹
心臟	心臟 🫀
怀孕女	怀孕女 🤰 🤰🏻 🤰🏼 🤰🏽 🤰🏾 🤰🏿 🤰🏻
女妈妈	女妈妈 🤰 🤰🏻 🤰🏼 🤰🏽 🤰🏾 🤰🏿 🤰🏻
愚鳩	愚鳩 🦤
愚鸠	愚鸠 🦤
感人	感人 🥹
感恩	感恩 🥹
慢走女	慢走女 🚶🏻‍♀️
慢走男	慢走男 🚶🏻‍♂️
憋屈女	憋屈女 🙎🏻‍♀️
憋屈男	憋屈男 🙎🏻‍♂️
懷孕女	懷孕女 🤰🏻
懷孕男	懷孕男 🫃🏻
戏法女	戏法女 🤹🏻‍♀️
戏法男	戏法男 🤹🏻‍♂️
戲法女	戲法女 🤹🏻‍♀️
戲法男	戲法男 🤹🏻‍♂️
戶	戶 🪟
户	户 🪟
所以呢女	所以呢女 🤷🏻‍♀️
所以呢男	所以呢男 🤷🏻‍♂️
手指	手指 🫵🏻
手杖	手杖 🩼
手球女	手球女 🤾🏻‍♀️
手球男	手球男 🤾🏻‍♂️
手風琴	手風琴 🪗
打坐女	打坐女 🧘🏻‍♀️
打坐男	打坐男 🧘🏻‍♂️
打招呼女	打招呼女 🙋🏻‍♀️
打招呼男	打招呼男 🙋🏻‍♂️
打球女	打球女 ⛹🏻‍♀️
打球男	打球男 ⛹🏻‍♂️
打疫苗	打疫苗 💉
打篮球女	打篮球女 ⛹🏻‍♀️
打篮球男	打篮球男 ⛹🏻‍♂️
打籃球女	打籃球女 ⛹🏻‍♀️
打籃球男	打籃球男 ⛹🏻‍♂️
托	托 🫴🏻
技工女	技工女 👩🏻‍🔧
技工男	技工男 👨🏻‍🔧
技师女	技师女 👩🏻‍🔧
技师男	技师男 👨🏻‍🔧
技師女	技師女 👩🏻‍🔧
技師男	技師男 👨🏻‍🔧
把戏女	把戏女 🤹🏻‍♀️
把戏男	把戏男 🤹🏻‍♂️
把戲女	把戲女 🤹🏻‍♀️
把戲男	把戲男 🤹🏻‍♂️
抓	抓 🫳🏻
护士女	护士女 👩🏻‍⚕️
护士男	护士男 👨🏻‍⚕️
抱	抱 🫂
招呼女	招呼女 🙋🏻‍♀️
招呼男	招呼男 🙋🏻‍♂️
招手女	招手女 🙋🏻‍♀️
招手男	招手男 🙋🏻‍♂️
挂镜	挂镜 🪞
按摩师女	按摩师女 💆🏻‍♀️
按摩师男	按摩师男 💆🏻‍♂️
按摩師女	按摩師女 💆🏻‍♀️
按摩師男	按摩師男 💆🏻‍♂️
按摩男	按摩男 💆🏻‍♂️
捏	捏 🤏🏻
捏著	捏著 🤏🏻
捲髮女	捲髮女 👩🏻‍🦱
捲髮男	捲髮男 👨🏻‍🦱
掛鏡	掛鏡 🪞
探長女	探長女 🕵🏻‍♀️
探長男	探長男 🕵🏻‍♂️
探长女	探长女 🕵🏻‍♀️
探长男	探长男 🕵🏻‍♂️
提示牌	提示牌 🪧
搖搖	搖搖 🪀
摇摇	摇摇 🪀
摊手女	摊手女 🤷🏻‍♀️
摊手男	摊手男 🤷🏻‍♂️
摔跤女	摔跤女 🤼🏻‍♀️
摔跤男	摔跤男 🤼🏻‍♂️
撮	撮 🤌🏻
擕手	擕手 🧑🏻‍🤝‍🧑🏻
攀岩女	攀岩女 🧗🏻‍♀️
攀岩男	攀岩男 🧗🏻‍♂️
攀巖女	攀巖女 🧗🏻‍♀️
攀巖男	攀巖男 🧗🏻‍♂️
攀登女	攀登女 🧗🏻‍♀️
攀登男	攀登男 🧗🏻‍♂️
攤手	攤手 🤷🏻
攤手女	攤手女 🤷🏻‍♀️
攤手男	攤手男 🤷🏻‍♂️
收声	收声 🫢
收聲	收聲 🫢
改錐	改錐 🪛
改锥	改锥 🪛
救火队女	救火队女 👩🏻‍🚒
救火队男	救火队男 👨🏻‍🚒
救火隊女	救火隊女 👩🏻‍🚒
救火隊男	救火隊男 👨🏻‍🚒
救生服	救生服 🦺
救生衣	救生衣 🦺
教书女	教书女 👩🏻‍🏫
教书男	教书男 👨🏻‍🏫
教师女	教师女 👩🏻‍🏫
教师男	教师男 👨🏻‍🏫
教師女	教師女 👩🏻‍🏫
教師男	教師男 👨🏻‍🏫
教書女	教書女 👩🏻‍🏫
教書男	教書男 👨🏻‍🏫
敬禮	敬禮 🫡
斑鳩琴	斑鳩琴 🪕
斑鸠琴	斑鸠琴 🪕
斜眼	斜眼 😏
斧	斧 🪓
新妇	新妇 👰🏻‍♀️
新娘中性	新娘中性 👰🏻
新娘男	新娘男 👰🏻‍♂️
新婦	新婦 👰🏻‍♀️
新郎女	新郎女 🤵🏻‍♀️
旄牛	旄牛 🦬
无助女	无助女 🙍🏻‍♀️
无助男	无助男 🙍🏻‍♂️
无所谓女	无所谓女 🤷🏻‍♀️
无所谓男	无所谓男 🤷🏻‍♂️
无望女	无望女 🙍🏻‍♀️
无望男	无望男 🙍🏻‍♂️
无能为力女	无能为力女 🤷🏻‍♀️
无能为力男	无能为力男 🤷🏻‍♂️
昆虫	昆虫 🪲
昆蟲	昆蟲 🪲
明星女	明星女 👩🏻‍🎤️
明星男	明星男 👨🏻‍🎤️
晓不得女	晓不得女 🤷🏻‍♀️
晓不得男	晓不得男 🤷🏻‍♂️
暗夜精灵女	暗夜精灵女 🧝🏻‍♀️
暗夜精灵男	暗夜精灵男 🧝🏻‍♂️
暗夜精靈女	暗夜精靈女 🧝🏻‍♀️
暗夜精靈男	暗夜精靈男 🧝🏻‍♂️
曉不得女	曉不得女 🤷🏻‍♀️
曉不得男	曉不得男 🤷🏻‍♂️
曱甴	曱甴 🪳
服务员女	服务员女 💁🏻‍♀️
服务员男	服务员男 💁🏻‍♂️
服務員女	服務員女 💁🏻‍♀️
服務員男	服務員男 💁🏻‍♂️
木星	木星 🪐
木柴	木柴 🪵
木頭	木頭 🪵
未睡醒	未睡醒 😵‍💫
未瞓醒	未瞓醒 😵‍💫
机器腿	机器腿 🦿
机器臂	机器臂 🦾
机械腿	机械腿 🦿
机械臂	机械臂 🦾
机长女	机长女 👩🏻‍✈️
机长男	机长男 👨🏻‍✈️
杂技女	杂技女 🤹🏻‍♀️
杂技男	杂技男 🤹🏻‍♂️
杖	杖 🦯
杠铃女	杠铃女 🏋🏻‍♀️
杠铃男	杠铃男 🏋🏻‍♂️
条子女	条子女 👮🏻‍♀️
条子男	条子男 👮🏻‍♂️
柔道女	柔道女 🤼🏻‍♀️
柔道男	柔道男 🤼🏻‍♂️
柴	柴 🪵
柺杖	柺杖 🩼
树獭	树獭 🦥
核子弹	核子弹 ☢️
核子彈	核子彈 ☢️
核弹	核弹 ☢️
核彈	核彈 ☢️
核电	核电 ⚛️
核能	核能 ⚛️
核電	核電 ⚛️
桑拿女	桑拿女 🧖🏻‍♀️
桑拿男	桑拿男 🧖🏻‍♂️
條子女	條子女 👮🏻‍♀️
條子男	條子男 👮🏻‍♂️
梯	梯 🪜
棕圆	棕圆 🟤
棕圓	棕圓 🟤
棕心	棕心 🤎
槓鈴女	槓鈴女 🏋🏻‍♀️
槓鈴男	槓鈴男 🏋🏻‍♂️
樹懶	樹懶 🦥
樹獺	樹獺 🦥
橄欖	橄欖 🫒
橘色	橘色 🟧
橘黃	橘黃 🟧
橘黃色	橘黃色 🟧
橘黄	橘黄 🟧
橘黄色	橘黄色 🟧
橙	橙 🟧
橙圆	橙圆 🟠
橙圓	橙圓 🟠
橙色	橙色 🟧
機器腿	機器腿 🦿
機器臂	機器臂 🦾
機械腿	機械腿 🦿
機械臂	機械臂 🦾
機長女	機長女 👩🏻‍✈️
機長男	機長男 👨🏻‍✈️
欢呼女	欢呼女 🙋🏻‍♀️
欢呼男	欢呼男 🙋🏻‍♂️
欢迎女	欢迎女 🙋🏻‍♀️
欢迎男	欢迎男 🙋🏻‍♂️
歌厅	歌厅 🪩
歌廳	歌廳 🪩
歌手女	歌手女 👩🏻‍🎤️
歌手男	歌手男 👨🏻‍🎤️
歌星女	歌星女 👩🏻‍🎤️
歌星男	歌星男 👨🏻‍🎤️
歌舞厅	歌舞厅 🪩
歌舞廳	歌舞廳 🪩
歡呼女	歡呼女 🙋🏻‍♀️
歡呼男	歡呼男 🙋🏻‍♂️
歡迎女	歡迎女 🙋🏻‍♀️
歡迎男	歡迎男 🙋🏻‍♂️
止血胶布	止血胶布 🩹
止血膠布	止血膠布 🩹
残杖	残杖 🩼
残疾	残疾 🧑🏻‍🦼 🧑🏻‍🦽
残疾人	残疾人 🧑🏻‍🦼 🧑🏻‍🦽
残疾人女	残疾人女 👩🏻‍🦼 👩🏻‍🦽
残疾人男	残疾人男 👨🏻‍🦼 👨🏻‍🦽
残疾女	残疾女 👩🏻‍🦼 👩🏻‍🦽
残疾男	残疾男 👨🏻‍🦼 👨🏻‍🦽
殘杖	殘杖 🩼
殘疾	殘疾 🧑🏻‍🦼 🧑🏻‍🦽
殘疾人	殘疾人 🧑🏻‍🦼 🧑🏻‍🦽
殘疾人女	殘疾人女 👩🏻‍🦼 👩🏻‍🦽
殘疾人男	殘疾人男 👨🏻‍🦼 👨🏻‍🦽
殘疾女	殘疾女 👩🏻‍🦼 👩🏻‍🦽
殘疾男	殘疾男 👨🏻‍🦼 👨🏻‍🦽
殭屍女	殭屍女 🧟‍♀️
殭屍男	殭屍男 🧟‍♂️
比愛心	比愛心 🫶🏻
比爱心	比爱心 🫶🏻
氂牛	氂牛 🦬
民工女	民工女 👷🏻‍♀️
民工男	民工男 👷🏻‍♂️
民警女	民警女 👮🏻‍♀️
民警男	民警男 👮🏻‍♂️
氣泡	氣泡 🫧
水獺	水獺 🦦
水球女	水球女 🤽🏻‍♀️
水球男	水球男 🤽🏻‍♂️
沒睡醒	沒睡醒 😵‍💫
沒門女	沒門女 🙅🏻‍♀️
沒門男	沒門男 🙅🏻‍♂️
沒電	沒電 🪫
没电	没电 🪫
没睡醒	没睡醒 😵‍💫
没门女	没门女 🙅🏻‍♀️
没门男	没门男 🙅🏻‍♂️
沮丧女	沮丧女 🙍🏻‍♀️
沮丧男	沮丧男 🙍🏻‍♂️
沮喪女	沮喪女 🙍🏻‍♀️
沮喪男	沮喪男 🙍🏻‍♂️
油燈	油燈 🪔
法官女	法官女 👩🏻‍⚖️
法官男	法官男 👨🏻‍⚖️
法师女	法师女 🧙🏻‍♀️
法师男	法师男 🧙🏻‍♂️
法師女	法師女 🧙🏻‍♀️
法師男	法師男 🧙🏻‍♂️
法蒂瑪之手	法蒂瑪之手 🪬
泡	泡 🫧
泳裤	泳裤 🩲
泳褲	泳褲 🩲
洋服	洋服 🤵🏻
洋服女	洋服女 🤵🏻‍♀️
洋服男	洋服男 🤵🏻‍♂️
洋蒜	洋蒜 🧅
洋蔥	洋蔥 🧅
浮潛	浮潛 🤿
浮潜	浮潜 🤿
海狮	海狮 🦭
海獅	海獅 🦭
消防员女	消防员女 👩🏻‍🚒
消防员男	消防员男 👨🏻‍🚒
消防員女	消防員女 👩🏻‍🚒
消防員男	消防員男 👨🏻‍🚒
渡渡鳥	渡渡鳥 🦤
游泳圈	游泳圈 🛟
游泳女	游泳女 🏊🏻‍♀️
游泳男	游泳男 🏊🏻‍♂️
溜溜球	溜溜球 🪀
滅火隊女	滅火隊女 👩🏻‍🚒
滅火隊男	滅火隊男 👨🏻‍🚒
滑雪靴	滑雪靴 🎿
漫步女	漫步女 🚶🏻‍♀️
漫步男	漫步男 🚶🏻‍♂️
潛水	潛水 🤿
激动	激动 ❤️‍🔥
激動	激動 ❤️‍🔥
激情	激情 ❤️‍🔥
火烈鳥	火烈鳥 🦩
火热	火热 ❤️‍🔥
火熱	火熱 ❤️‍🔥
火警女	火警女 👩🏻‍🚒
火警男	火警男 👨🏻‍🚒
灭火队女	灭火队女 👩🏻‍🚒
灭火队男	灭火队男 👨🏻‍🚒
灯神女	灯神女 🧞‍♀️
灯神男	灯神男 🧞‍♂️
热心	热心 ❤️‍🔥
無助女	無助女 🙍🏻‍♀️
無助男	無助男 🙍🏻‍♂️
無所謂女	無所謂女 🤷🏻‍♀️
無所謂男	無所謂男 🤷🏻‍♂️
無望女	無望女 🙍🏻‍♀️
無望男	無望男 🙍🏻‍♂️
無能爲力女	無能爲力女 🤷🏻‍♀️
無能爲力男	無能爲力男 🤷🏻‍♂️
熔化	熔化 🫠
熱心	熱心 ❤️‍🔥
燈神女	燈神女 🧞‍♀️
燈神男	燈神男 🧞‍♂️
爬泳女	爬泳女 🏊🏻‍♀️
爬泳男	爬泳男 🏊🏻‍♂️
牛油	牛油 🧈
牡蠣	牡蠣 🦪
牦牛	牦牛 🦬
状师女	状师女 👩🏻‍⚖️
状师男	状师男 👨🏻‍⚖️
狀師女	狀師女 👩🏻‍⚖️
狀師男	狀師男 👨🏻‍⚖️
狗繩	狗繩 🐕‍🦺
狗绳	狗绳 🐕‍🦺
狸	狸 🦫
猛犸	猛犸 🦣
猛獁	猛獁 🦣
猛玛象	猛玛象 🦣
猛瑪象	猛瑪象 🦣
獸人	獸人 🧌
王	王 🫅🏻
王冠女	王冠女 🤴🏻
王冠男	王冠男 👸🏻
王男	王男 👸🏻
玛利亚之手	玛利亚之手 🪬
玛黛茶	玛黛茶 🧉
玻璃罐	玻璃罐 🫙
玻璃鏡	玻璃鏡 🪞
玻璃镜	玻璃镜 🪞
珊瑚礁	珊瑚礁 🪸
班主住女	班主住女 👩🏻‍🏫
班主住男	班主住男 👨🏻‍🏫
班卓琴	班卓琴 🪕
球员	球员 ⛹🏻
球员女	球员女 ⛹🏻‍♀️
球员男	球员男 ⛹🏻‍♂️
球員	球員 ⛹🏻
球員女	球員女 ⛹🏻‍♀️
球員男	球員男 ⛹🏻‍♂️
理发女	理发女 💇🏻‍♀️
理发男	理发男 💇🏻‍♂️
理髮女	理髮女 💇🏻‍♀️
理髮男	理髮男 💇🏻‍♂️
瑪利亞之手	瑪利亞之手 🪬
瑪黛茶	瑪黛茶 🧉
生物科技	生物科技 🧬
生蠔	生蠔 🦪
田径女	田径女 🏃🏻‍♀️
田径男	田径男 🏃🏻‍♂️
田徑女	田徑女 🏃🏻‍♀️
田徑男	田徑男 🏃🏻‍♂️
甲蟲	甲蟲 🪲
电动轮椅	电动轮椅 🦼
画家女	画家女 👩🏻‍🎨
画家男	画家男 👨🏻‍🎨
畫家女	畫家女 👩🏻‍🎨
畫家男	畫家男 👨🏻‍🎨
疫苗	疫苗 💉
疼心	疼心 ❤️‍🩹
痛心	痛心 ❤️‍🩹
白	白 ⬜️
白发女	白发女 👩🏻‍🦳
白发男	白发男 👨🏻‍🦳
白圆	白圆 ⚪️
白圓	白圓 ⚪️
白头发	白头发 🧑🏻‍🦳
白头发女	白头发女 👩🏻‍🦳
白头发男	白头发男 👨🏻‍🦳
白心	白心 🤍
白熊	白熊 🐻‍❄️
白色	白色 ⬜️
白領女	白領女 👩🏻‍💼
白領男	白領男 👨🏻‍💼
白頭髮	白頭髮 🧑🏻‍🦳
白頭髮女	白頭髮女 👩🏻‍🦳
白頭髮男	白頭髮男 👨🏻‍🦳
白领女	白领女 👩🏻‍💼
白领男	白领男 👨🏻‍💼
白髮女	白髮女 👩🏻‍🦳
白髮男	白髮男 👨🏻‍🦳
皮卡	皮卡 🛻
皮納塔	皮納塔 🪅
皱眉女	皱眉女 🙍🏻‍♀️
皱眉男	皱眉男 🙍🏻‍♂️
皺眉女	皺眉女 🙍🏻‍♀️
皺眉男	皺眉男 🙍🏻‍♂️
盆景	盆景 🪴
盒装饮料	盒装饮料 🧃
盒裝飲料	盒裝飲料 🧃
盔	盔 🪖
盘腿女	盘腿女 🧘🏻‍♀️
盘腿男	盘腿男 🧘🏻‍♂️
盤腿女	盤腿女 🧘🏻‍♀️
盤腿男	盤腿男 🧘🏻‍♂️
盲	盲 🧑🏻‍🦯
盲人女	盲人女 👩🏻‍🦯
盲人男	盲人男 👨🏻‍🦯
盲女	盲女 👩🏻‍🦯
盲男	盲男 👨🏻‍🦯
直梯	直梯 🛗
看守女	看守女 💂🏻‍♀️
看守男	看守男 💂🏻‍♂️
真好女	真好女 🙆🏻‍♀️
真好男	真好男 🙆🏻‍♂️
睇唔明	睇唔明 😵‍💫
睡莲	睡莲 🪷
睡蓮	睡蓮 🪷
瞎子女	瞎子女 👩🏻‍🦯
瞎子男	瞎子男 👨🏻‍🦯
短褲	短褲 🩲 🩳
石	石 🪨
石块	石块 🪨
石塊	石塊 🪨
研究员女	研究员女 👩🏻‍🔬
研究员男	研究员男 👨🏻‍🔬
研究員女	研究員女 👩🏻‍🔬
研究員男	研究員男 👨🏻‍🔬
硬幣	硬幣 🪙
硴	硴 🦪
磕头女	磕头女 🙇🏻‍♀️
磕头男	磕头男 🙇🏻‍♂️
磕頭女	磕頭女 🙇🏻‍♀️
磕頭男	磕頭男 🙇🏻‍♂️
神探女	神探女 🕵🏻‍♀️
神探男	神探男 🕵🏻‍♂️
神祕	神祕 😶‍🌫️
神秘	神秘 😶‍🌫️
禿女	禿女 👩🏻‍🦲
禿男	禿男 👨🏻‍🦲
禿頭女	禿頭女 👩🏻‍🦲
禿頭男	禿頭男 👨🏻‍🦲
秃头女	秃头女 👩🏻‍🦲
秃头男	秃头男 👨🏻‍🦲
秃女	秃女 👩🏻‍🦲
秃男	秃男 👨🏻‍🦲
种地女	种地女 👩🏻‍🌾
种地男	种地男 👨🏻‍🌾
种田女	种田女 👩🏻‍🌾
种田男	种田男 👨🏻‍🌾
科学家女	科学家女 👩🏻‍🔬
科学家男	科学家男 👨🏻‍🔬
科學家女	科學家女 👩🏻‍🔬
科學家男	科學家男 👨🏻‍🔬
科研人员女	科研人员女 👩🏻‍🔬
科研人员男	科研人员男 👨🏻‍🔬
科研人員女	科研人員女 👩🏻‍🔬
科研人員男	科研人員男 👨🏻‍🔬
程序员女	程序员女 👩🏻‍💻
程序员男	程序员男 👨🏻‍💻
程序員女	程序員女 👩🏻‍💻
程序員男	程序員男 👨🏻‍💻
稍	稍 🤌🏻
種地女	種地女 👩🏻‍🌾
種地男	種地男 👨🏻‍🌾
種田女	種田女 👩🏻‍🌾
種田男	種田男 👨🏻‍🌾
空氣汙染	空氣汙染 🏭
空电池	空电池 🪫
空電池	空電池 🪫
窗子	窗子 🪟
窗戶	窗戶 🪟
窝夫	窝夫 🧇
窥	窥 🫣
窩夫	窩夫 🧇
窺	窺 🫣
立定	立定 🧍🏻
立定女	立定女 🧍🏻‍♀️
立定男	立定男 🧍🏻‍♂️
站女	站女 🧍🏻‍♀️
站男	站男 🧍🏻‍♂️
站立女	站立女 🧍🏻‍♀️
站立男	站立男 🧍🏻‍♂️
等於	等於 🟰
精灵女	精灵女 🧝🏻‍♀️
精灵族女	精灵族女 🧝🏻‍♀️
精灵族男	精灵族男 🧝🏻‍♂️
精灵男	精灵男 🧝🏻‍♂️
精靈女	精靈女 🧝🏻‍♀️
精靈族女	精靈族女 🧝🏻‍♀️
精靈族男	精靈族男 🧝🏻‍♂️
精靈男	精靈男 🧝🏻‍♂️
糾結女	糾結女 🤦🏻‍♀️
糾結男	糾結男 🤦🏻‍♂️
紅	紅 🟥
紅圓	紅圓 🔴
紅猩猩	紅猩猩 🦧
紅色	紅色 🟥
紅豆	紅豆 🫘
紅頭髮	紅頭髮 🧑🏻‍🦰
紅頭髮女	紅頭髮女 👩🏻‍🦰
紅頭髮男	紅頭髮男 👨🏻‍🦰
紅髮女	紅髮女 👩🏻‍🦰
紅髮男	紅髮男 👨🏻‍🦰
紅鶴	紅鶴 🦩
紅鸛	紅鸛 🦩
紗麗	紗麗 🥻
紙鳶	紙鳶 🪁
紙鷂	紙鷂 🪁
紫	紫 🟪
紫圆	紫圆 🟣
紫圓	紫圓 🟣
紫色	紫色 🟪
結	結 🪢
絡腮鬍	絡腮鬍 🧔🏻
絡腮鬍女	絡腮鬍女 🧔🏻‍♀️
絡腮鬍男	絡腮鬍男 🧔🏻‍♂️
綠	綠 🟩
綠圓	綠圓 🟢
綠帽	綠帽 🪖
線蟲	線蟲 🪱
縫衣針	縫衣針 🪡
繩結	繩結 🪢
纏頭女	纏頭女 👳🏾‍♀️
纏頭男	纏頭男 👳🏾‍♂️
纠结女	纠结女 🤦🏻‍♀️
纠结男	纠结男 🤦🏻‍♂️
红	红 🟥
红发女	红发女 👩🏻‍🦰
红发男	红发男 👨🏻‍🦰
红圆	红圆 🔴
红头发	红头发 🧑🏻‍🦰
红头发女	红头发女 👩🏻‍🦰
红头发男	红头发男 👨🏻‍🦰
红猩猩	红猩猩 🦧
红色	红色 🟥
红鹤	红鹤 🦩
红鹳	红鹳 🦩
纱丽	纱丽 🥻
纸鸢	纸鸢 🪁
纸鹞	纸鹞 🪁
线虫	线虫 🪱
络腮胡	络腮胡 🧔🏻
络腮胡女	络腮胡女 🧔🏻‍♀️
络腮胡男	络腮胡男 🧔🏻‍♂️
绿	绿 🟩
绿圆	绿圆 🟢
绿帽	绿帽 🪖
缝衣针	缝衣针 🪡
缠头女	缠头女 👳🏾‍♀️
缠头男	缠头男 👳🏾‍♂️
羽	羽 🪶
老师女	老师女 👩🏻‍🏫
老师男	老师男 👨🏻‍🏫
老師女	老師女 👩🏻‍🏫
老師男	老師男 👨🏻‍🏫
老花鏡	老花鏡 👓
老花镜	老花镜 👓
耳聋	耳聋 🧏🏻
耳聋女	耳聋女 🧏🏻‍♀️
耳聋男	耳聋男 🧏🏻‍♂️
耳聾	耳聾 🧏🏻
耳聾女	耳聾女 🧏🏻‍♀️
耳聾男	耳聾男 🧏🏻‍♂️
聋哑人	聋哑人 🧏🏻
聋哑人女	聋哑人女 🧏🏻‍♀️
聋哑人男	聋哑人男 🧏🏻‍♂️
聋哑女	聋哑女 🧏🏻‍♀️
聋哑男	聋哑男 🧏🏻‍♂️
聋女	聋女 🧏🏻‍♀️
聋子女	聋子女 🧏🏻‍♀️
聋子男	聋子男 🧏🏻‍♂️
聋男	聋男 🧏🏻‍♂️
职员女	职员女 👩🏻‍💼
职员男	职员男 👨🏻‍💼
聖誕奶奶	聖誕奶奶 🤶🏻
聖誕老奶奶	聖誕老奶奶 🤶🏻
職員女	職員女 👩🏻‍💼
職員男	職員男 👨🏻‍💼
聽不見	聽不見 🧏🏻
聽不見女	聽不見女 🧏🏻‍♀️
聽不見男	聽不見男 🧏🏻‍♂️
聽診器	聽診器 🩺
聾	聾 🧏🏻
聾啞	聾啞 🧏🏻
聾啞人	聾啞人 🧏🏻
聾啞人女	聾啞人女 🧏🏻‍♀️
聾啞人男	聾啞人男 🧏🏻‍♂️
聾啞女	聾啞女 🧏🏻‍♀️
聾啞男	聾啞男 🧏🏻‍♂️
聾女	聾女 🧏🏻‍♀️
聾子	聾子 🧏🏻
聾子女	聾子女 🧏🏻‍♀️
聾子男	聾子男 🧏🏻‍♂️
聾男	聾男 🧏🏻‍♂️
肩並肩	肩並肩 🧑🏻‍🤝‍🧑🏻
肩并肩	肩并肩 🧑🏻‍🤝‍🧑🏻
胡	胡 🧔🏻
胡女	胡女 🧔🏻‍♀️
胡子	胡子 🧔🏻
胡子女	胡子女 🧔🏻‍♀️
胡子男	胡子男 🧔🏻‍♂️
胡男	胡男 🧔🏻‍♂️
胡须	胡须 🧔🏻
胡须女	胡须女 🧔🏻‍♀️
胡须男	胡须男 🧔🏻‍♂️
胶布	胶布 🩹
胸片	胸片 🩻
胸透	胸透 🩻
膏布	膏布 🩹
膠布	膠布 🩹
自來水	自來水 🚰
自动轮椅	自动轮椅 🦼
自動輪椅	自動輪椅 🦼
自来水	自来水 🚰
自由泳女	自由泳女 🏊🏻‍♀️
自由泳男	自由泳男 🏊🏻‍♂️
舉重女	舉重女 🏋🏻‍♀️
舉重男	舉重男 🏋🏻‍♂️
舞厅	舞厅 🪩
舞廳	舞廳 🪩
舰长女	舰长女 👩🏻‍✈️
舰长男	舰长男 👨🏻‍✈️
船長女	船長女 👩🏻‍✈️
船長男	船長男 👨🏻‍✈️
船长女	船长女 👩🏻‍✈️
船长男	船长男 👨🏻‍✈️
艦長女	艦長女 👩🏻‍✈️
艦長男	艦長男 👨🏻‍✈️
艺人女	艺人女 👩🏻‍🎨
艺人男	艺人男 👨🏻‍🎨
艺术家女	艺术家女 👩🏻‍🎨
艺术家男	艺术家男 👨🏻‍🎨
芝士火鍋	芝士火鍋 🫕
芭蕾	芭蕾 🩰
芭蕾舞	芭蕾舞 🩰
芭蕾鞋	芭蕾鞋 🩰
英雄女	英雄女 🦸🏻‍♀️
英雄男	英雄男 🦸🏻‍♂️
茅屋	茅屋 🛖
茅舍	茅舍 🛖
茅草屋	茅草屋 🛖
茅草房	茅草房 🛖
茶壺	茶壺 🫖
草㡌	草㡌 👒
草屋	草屋 🛖
草舍	草舍 🛖
莲	莲 🪷
華夫	華夫 🧇
華夫餅	華夫餅 🧇
蒸桑拿女	蒸桑拿女 🧖🏻‍♀️
蒸桑拿男	蒸桑拿男 🧖🏻‍♂️
蒼蠅	蒼蠅 🪰
蓝	蓝 🟦
蓝圆	蓝圆 🔵
蓝色	蓝色 🟦
蓮	蓮 🪷
蓮花	蓮花 🪷
蔬菜球	蔬菜球 🧆
藍	藍 🟦
藍圓	藍圓 🔵
藍色	藍色 🟦
藍莓	藍莓 🫐
藝人女	藝人女 👩🏻‍🎨
藝人男	藝人男 👨🏻‍🎨
藝術家女	藝術家女 👩🏻‍🎨
藝術家男	藝術家男 👨🏻‍🎨
虚伪	虚伪 🥸
虚化	虚化 🫥
虛僞	虛僞 🥸
虛化	虛化 🫥
蚵仔	蚵仔 🦪
蛋餅	蛋餅 🥞
蛋饼	蛋饼 🥞
蛔	蛔 🪱
蛔虫	蛔虫 🪱
蛔蟲	蛔蟲 🪱
蝇	蝇 🪰
螺絲刀	螺絲刀 🪛
蠅	蠅 🪰
蠔	蠔 🦪
蠕	蠕 🪱
蠕蟲	蠕蟲 🪱
血液	血液 🩸
血滴	血滴 🩸
行人女	行人女 🚶🏻‍♀️
行人男	行人男 🚶🏻‍♂️
行走女	行走女 🚶🏻‍♀️
行走男	行走男 🚶🏻‍♂️
衛士女	衛士女 💂🏻‍♀️
衛士男	衛士男 💂🏻‍♂️
衛門女	衛門女 💂🏻‍♀️
衛門男	衛門男 💂🏻‍♂️
衝浪女	衝浪女 🏄🏻‍♀️
衝浪男	衝浪男 🏄🏻‍♂️
裤头	裤头 🩲
裹头女	裹头女 👳🏾‍♀️
裹头男	裹头男 👳🏾‍♂️
裹頭女	裹頭女 👳🏾‍♀️
裹頭男	裹頭男 👳🏾‍♂️
褲頭	褲頭 🩲
西服	西服 🤵🏻
西服女	西服女 🤵🏻‍♀️
西服男	西服男 🤵🏻‍♂️
西装	西装 🤵🏻
西装女	西装女 🤵🏻‍♀️
西装男	西装男 🤵🏻‍♂️
西裝	西裝 🤵🏻
西裝女	西裝女 🤵🏻‍♀️
西裝男	西裝男 🤵🏻‍♂️
認不得女	認不得女 🤷🏻‍♀️
認不得男	認不得男 🤷🏻‍♂️
誘餌	誘餌 🪤
課堂女	課堂女 👩🏻‍🏫
課堂男	課堂男 👨🏻‍🏫
課室女	課室女 👩🏻‍🏫
課室男	課室男 👨🏻‍🏫
請女	請女 💁🏻‍♀️
請男	請男 💁🏻‍♂️
謝頂女	謝頂女 👩🏻‍🦲
謝頂男	謝頂男 👨🏻‍🦲
警察女	警察女 👮🏻‍♀️
警察男	警察男 👮🏻‍♂️
警示牌	警示牌 🪧
護士女	護士女 👩🏻‍⚕️
護士男	護士男 👨🏻‍⚕️
认不得女	认不得女 🤷🏻‍♀️
认不得男	认不得男 🤷🏻‍♂️
诱饵	诱饵 🪤
请女	请女 💁🏻‍♀️
请男	请男 💁🏻‍♂️
课堂女	课堂女 👩🏻‍🏫
课堂男	课堂男 👨🏻‍🏫
课室女	课室女 👩🏻‍🏫
课室男	课室男 👨🏻‍🏫
谢顶女	谢顶女 👩🏻‍🦲
谢顶男	谢顶男 👨🏻‍🦲
貨卡	貨卡 🛻
賣藝女	賣藝女 🤹🏻‍♀️
賣藝男	賣藝男 🤹🏻‍♂️
賽艇女	賽艇女 🚣🏻‍♀️
賽艇男	賽艇男 🚣🏻‍♂️
货卡	货卡 🛻
赛艇女	赛艇女 🚣🏻‍♀️
赛艇男	赛艇男 🚣🏻‍♂️
赤	赤 🟥
赭圆	赭圆 🟤
赭圓	赭圓 🟤
赭心	赭心 🤎
走女	走女 🚶🏻‍♀️
走男	走男 🚶🏻‍♂️
超人女	超人女 🦸🏻‍♀️
超人男	超人男 🦸🏻‍♂️
跑女	跑女 🏃🏻‍♀️
跑男女	跑男女 🏃🏻‍♀️
跑男男	跑男男 🏃🏻‍♂️
跛	跛 🧑🏻‍🦼 🧑🏻‍🦽
跛女	跛女 👩🏻‍🦼 👩🏻‍🦽
跛男	跛男 👨🏻‍🦼 👨🏻‍🦽
跨性別	跨性別 ⚧️ 🏳‍⚧️
跨性別旗	跨性別旗 🏳‍⚧️
跨性别	跨性别 ⚧️ 🏳‍⚧️
跨性别旗	跨性别旗 🏳‍⚧️
跪下	跪下 🧎🏻
跪下女	跪下女 🧎🏻‍♀️
跪下男	跪下男 🧎🏻‍♂️
跪女	跪女 🧎🏻‍♀️
跪拜女	跪拜女 🙇🏻‍♀️ 🧎🏻‍♀️
跪拜男	跪拜男 🙇🏻‍♂️ 🧎🏻‍♂️
跪男	跪男 🧎🏻‍♂️
跳伞	跳伞 🪂
跳傘	跳傘 🪂
蹙眉女	蹙眉女 🙍🏻‍♀️
蹙眉男	蹙眉男 🙍🏻‍♂️
蹦迪	蹦迪 🪩
身份證	身份證 🪪
身孕女	身孕女 🤰🏻
身孕男	身孕男 🫃🏻
車胎	車胎 🛞
車輪	車輪 🛞
輪	輪 🛞
輪滑	輪滑 🛼
輪胎	輪胎 🛞
车胎	车胎 🛞
轮	轮 🛞
轮滑	轮滑 🛼
農戶女	農戶女 👩🏻‍🌾
農戶男	農戶男 👨🏻‍🌾
農民女	農民女 👩🏻‍🌾
農民工女	農民工女 👷🏻‍♀️
農民工男	農民工男 👷🏻‍♂️
農民男	農民男 👨🏻‍🌾
达玛尔	达玛尔 🫔
运动㡌	运动㡌 🧢
这边女	这边女 💁🏻‍♀️
这边男	这边男 💁🏻‍♂️
进城务工人员女	进城务工人员女 👷🏻‍♀️
进城务工人员男	进城务工人员男 👷🏻‍♂️
连体衣	连体衣 🩱
迪厅	迪厅 🪩
迪廳	迪廳 🪩
迴力鏢	迴力鏢 🪃
迴旋鏢	迴旋鏢 🪃
這邊女	這邊女 💁🏻‍♀️
這邊男	這邊男 💁🏻‍♂️
連體衣	連體衣 🩱
進城務工人員女	進城務工人員女 👷🏻‍♀️
進城務工人員男	進城務工人員男 👷🏻‍♂️
運動㡌	運動㡌 🧢
達瑪爾	達瑪爾 🫔
醫生女	醫生女 👩🏻‍⚕️
醫生男	醫生男 👨🏻‍⚕️
醫者女	醫者女 👩🏻‍⚕️
醫者男	醫者男 👨🏻‍⚕️
野牛	野牛 🦬
金发女	金发女 👱🏼‍♀️
金发男	金发男 👱🏼‍♂️
金髮女	金髮女 👱🏼‍♀️
金髮男	金髮男 👱🏼‍♂️
金龜子	金龜子 🪲
金龟子	金龟子 🪲
針線	針線 🪡
鉤	鉤 🪝
鋸	鋸 🪚
鋼鏰	鋼鏰 🪙
鏡	鏡 🪞
鏡子	鏡子 🪞
针线	针线 🪡
钢镚	钢镚 🪙
钩	钩 🪝
锯	锯 🪚
镜	镜 🪞
長明燈	長明燈 🪔
長鼔	長鼔 🪘
长明灯	长明灯 🪔
长鼔	长鼔 🪘
門衛女	門衛女 💂🏻‍♀️
門衛男	門衛男 💂🏻‍♂️
閉口	閉口 🫢
間諜女	間諜女 🕵🏻‍♀️
間諜男	間諜男 🕵🏻‍♂️
门卫女	门卫女 💂🏻‍♀️
门卫男	门卫男 💂🏻‍♂️
闭口	闭口 🫢
间谍女	间谍女 🕵🏻‍♀️
间谍男	间谍男 🕵🏻‍♂️
阿拉丁灯神女	阿拉丁灯神女 🧞‍♀️
阿拉丁灯神男	阿拉丁灯神男 🧞‍♂️
阿拉丁燈神女	阿拉丁燈神女 🧞‍♀️
阿拉丁燈神男	阿拉丁燈神男 🧞‍♂️
阿根廷茶	阿根廷茶 🧉
降落傘	降落傘 🪂
陷阱	陷阱 🪤
隐身	隐身 😶‍🌫️ 🫥
隱祕	隱祕 😶‍🌫️
隱身	隱身 😶‍🌫️ 🫥
难	难 😵‍💫
雙板	雙板 ⛷️
雙板滑雪	雙板滑雪 ⛷️
雜技女	雜技女 🤹🏻‍♀️
雜技男	雜技男 🤹🏻‍♂️
難	難 😵‍💫
雪松	雪松 🎄
雪靴	雪靴 🎿
電動輪椅	電動輪椅 🦼
電梯	電梯 🛗
青	青 🟦
青圆	青圆 🔵
青圓	青圓 🔵
青色	青色 🟦
静坐女	静坐女 🧘🏻‍♀️
静坐男	静坐男 🧘🏻‍♂️
靜坐女	靜坐女 🧘🏻‍♀️
靜坐男	靜坐男 🧘🏻‍♂️
靠椅	靠椅 🪑
鞠躬女	鞠躬女 🙇🏻‍♀️
鞠躬男	鞠躬男 🙇🏻‍♂️
頭大女	頭大女 🤦🏻‍♀️
頭大男	頭大男 🤦🏻‍♂️
頭巾女	頭巾女 👳🏾‍♀️
頭巾男	頭巾男 👳🏾‍♂️
頭疼女	頭疼女 🤦🏻‍♀️
頭疼男	頭疼男 🤦🏻‍♂️
頭盔	頭盔 🪖
须	须 🧔🏻
须女	须女 🧔🏻‍♀️
须男	须男 🧔🏻‍♂️
風箏	風箏 🪁
餅	餅 🫓
餌	餌 🪤
饵	饵 🪤
騎單車女	騎單車女 🚴🏻‍♀️
騎單車男	騎單車男 🚴🏻‍♂️
騎自行車女	騎自行車女 🚴🏻‍♀️
騎自行車男	騎自行車男 🚴🏻‍♂️
騎行女	騎行女 🚴🏻‍♀️
騎行男	騎行男 🚴🏻‍♂️
騎車女	騎車女 🚴🏻‍♀️
騎車男	騎車男 🚴🏻‍♂️
骑单车女	骑单车女 🚴🏻‍♀️
骑单车男	骑单车男 🚴🏻‍♂️
骑自行车女	骑自行车女 🚴🏻‍♀️
骑自行车男	骑自行车男 🚴🏻‍♂️
骑行女	骑行女 🚴🏻‍♀️
骑行男	骑行男 🚴🏻‍♂️
骑车女	骑车女 🚴🏻‍♀️
骑车男	骑车男 🚴🏻‍♂️
體操女	體操女 🤸🏻‍♀️
體操男	體操男 🤸🏻‍♂️
高尔夫女	高尔夫女 🏌🏻‍♀️
高尔夫球女	高尔夫球女 🏌🏻‍♀️
高尔夫球男	高尔夫球男 🏌🏻‍♂️
高尔夫男	高尔夫男 🏌🏻‍♂️
高爾夫女	高爾夫女 🏌🏻‍♀️
高爾夫球女	高爾夫球女 🏌🏻‍♀️
高爾夫球男	高爾夫球男 🏌🏻‍♂️
高爾夫男	高爾夫男 🏌🏻‍♂️
高脚杯	高脚杯 🍷
高腳杯	高腳杯 🍷
髯	髯 🧔🏻
髯女	髯女 🧔🏻‍♀️
髯男	髯男 🧔🏻‍♂️
鬍	鬍 🧔🏻
鬍女	鬍女 🧔🏻‍♀️
鬍子	鬍子 🧔🏻
鬍子女	鬍子女 🧔🏻‍♀️
鬍子男	鬍子男 🧔🏻‍♂️
鬍男	鬍男 🧔🏻‍♂️
鬍鬚	鬍鬚 🧔🏻
鬍鬚女	鬍鬚女 🧔🏻‍♀️
鬍鬚男	鬍鬚男 🧔🏻‍♂️
鬚	鬚 🧔🏻
鬚女	鬚女 🧔🏻‍♀️
鬚男	鬚男 🧔🏻‍♂️
魔头女	魔头女 🦹🏻‍♀️
魔头男	魔头男 🦹🏻‍♂️
魔棒	魔棒 🪄
魔法女	魔法女 🧙🏻‍♀️
魔法师女	魔法师女 🧙🏻‍♀️
魔法师男	魔法师男 🧙🏻‍♂️
魔法師女	魔法師女 🧙🏻‍♀️
魔法師男	魔法師男 🧙🏻‍♂️
魔法男	魔法男 🧙🏻‍♂️
魔頭女	魔頭女 🦹🏻‍♀️
魔頭男	魔頭男 🦹🏻‍♂️
鰌魚	鰌魚 🦑
鳥巢	鳥巢 🪹 🪺
鳥羽	鳥羽 🪶
鳥蛋	鳥蛋 🪺
鳩鴿	鳩鴿 🦤
鴞	鴞 🦉
鴨舌㡌	鴨舌㡌 🧢
鷹嘴豆餅	鷹嘴豆餅 🧆
鸟羽	鸟羽 🪶
鸟蛋	鸟蛋 🪺
鸠鸽	鸠鸽 🦤
鸭舌㡌	鸭舌㡌 🧢
鸮	鸮 🦉
鹰嘴豆饼	鹰嘴豆饼 🧆
麻烦女	麻烦女 🤦🏻‍♀️
麻烦男	麻烦男 🤦🏻‍♂️
麻煩女	麻煩女 🤦🏻‍♀️
麻煩男	麻煩男 🤦🏻‍♂️
黃	黃 🟨
黃包車	黃包車 🛺
黃圓	黃圓 🟡
黃油	黃油 🧈
黃色	黃色 🟨
黄	黄 🟨
黄包车	黄包车 🛺
黄圆	黄圆 🟡
黄色	黄色 🟨
黑	黑 ⬛️
黑圆	黑圆 ⚫️
黑圓	黑圓 ⚫️
黑猫	黑猫 🐈‍⬛️
黑色	黑色 ⬛️
黑貓	黑貓 🐈‍⬛️
鼅鼄	鼅鼄 🕷️
𨋢	𨋢 🛗
虎码	虎码 🐯🐎 🐯🐴 🐅🐎 🐅🐴
秃码	秃码 👨‍🦲🐎 👨‍🦲🐴 👨🏻‍🦲🐎 👨🏻‍🦲🐴 🧑‍🦲🐎 🧑‍🦲🐴
兔码	兔码 🐇🐎 🐇🐴 🐰🐎 🐰🐴 
猫码	猫码 🐈🐎 🐈🐴 🐱🐎 🐱🐴 😺🐎 😺🐴 😸🐎 😸🐴 😹🐎 😹🐴
牛码	牛码 🐮🐎 🐮🐴 🐂🐎 🐂🐴 🐄🐎 🐄🐴
牛马	牛马 🐮🐎 🐮🐴 🐂🐎 🐂🐴 🐄🐎 🐄🐴
𮳱	𮳱 🐮🐎 🐮🐴 🐂🐎 🐂🐴 🐄🐎 🐄🐴
𤚴	𤚴 🐮🐎 🐮🐴 🐂🐎 🐂🐴 🐄🐎 🐄🐴
鼠码	鼠码 🐭🐎 🐭🐴 🐁🐎 🐁🐴 🐀🐎 🐀🐴
鸡码	鸡码 🐔🐎 🐔🐴 🐓🐎 🐓🐴 🐣🐎 🐣🐴 🐤🐎 🐤🐴 🐥🐎 🐥🐴
龙码	龙码 🐲🐎 🐲🐴 🐉🐎 🐉🐴
蛇码	蛇码 🐍🐎 🐍🐴
马码	马码 🐎🐴 🐴🐎
羊码	羊码 🐑🐴 🐑🐴 🐏🐎 🐏🐴 🐐🐎 🐐🐴
猴码	猴码 🐵🐎 🐵🐴 🐒🐎 🐒🐴 🙈🐎 🙈🐴
猪码	猪码 🐷🐎 🐷🐴 🐖🐎 🐖🐴 🐽🐎 🐽🐴
小鹤	小鹤 🤏🦩
秃然	秃然 👨‍🦲🧔🏻
小鹤音形	小鹤音形 🤏🦩🎹👌 🤏🦩🎹🆗️ 🤏🦩🌥❤ 🤏🦩🦅✡
秃然音形	秃然音形 👨‍🦲🧔🏻🎹👌 👨‍🦲🧔🏻🎹🆗️ 👨‍🦲🧔🏻🌥❤ 👨‍🦲🧔🏻🦅✡
龙王	🐲🫅🏻 🐉🫅🏻
浪码	浪码 🌊🐎 🌊🐴
浪叔叔	浪叔叔 🌊👴👴 🌊👨‍🦳👨‍🦳 🌊📕📕 🌊📖📖 🌊🌳🌳 🌊🌲🌲
B佬	B佬 🅱👴 🅱👨‍🦳 🇧👴 🇧👨‍🦳
秃秃	秃秃 👨‍🦲👨‍🦲 🧑‍🦲🧑‍🦲 🧑🏻‍🦲🧑🏻‍🦲 👩‍🦲👩‍🦲 👨🏻‍🦲👨🏻‍🦲 👨🏼‍🦲👨🏼‍🦲 👨🏽‍🦲👨🏽‍🦲 👨🏾‍🦲👨🏾‍🦲
五笔	五笔 🕔✏ 5⃣✏
哥哥	哥哥 🈹🈹
割割	割割 🈹🈹
牛逼	牛逼 🐮🍺 🐮🍻 🐂🍺 🐂🍻
牛批	牛批 🐮🍺 🐮🍻 🐂🍺 🐂🍻
牛啤	牛啤 🐮🍺 🐮🍻 🐂🍺 🐂🍻
三码郑码	三码郑码 骉郑码 🐴🐴🐴💉🐎 🐎🐎🐎💉🐴
骉郑码	骉郑码 三码郑码 🐴🐴🐴💉🐎 🐎🐎🐎💉🐴
三郑	三郑 三码郑码 骉郑码 🐴🐴🐴💉🐎 🐎🐎🐎💉🐴
鸡你太美	鸡你太美 只因你太美 🐔🫵🏻👐💅 🐔👈🌞💅
只因你太美	只因你太美 鸡你太美 🐔🫵🏻👐💅 🐔👈🌞💅
只囙你太美	只囙你太美 鸡你太美 🐔🫵🏻👐💅 🐔👈🌞💅
小虾米	小虾米 🤏🦐🍚 🤏🏻🍤🍙
小虾屎	小虾屎 🤏🦐💩 🤏🏻🍤💩
飞码	飞码 ✈🐎 ✈🐴 🛩🐎 🛩🐴
声笔飞码	声笔飞码 🎤✏✈🐎 🎤✏✈🐴 🎙✏🛩🐎 🎙✏🛩🐴
珍珍	珍珍 🧋🧋
梯子	梯子 🪜 🛝
滑梯	滑梯 🛝
珍珠奶茶	珍珠奶茶 🧋
奶茶	奶茶 🧋
电梯	电梯 🛗
轮滑鞋	轮滑鞋 🛼
旱冰鞋	旱冰鞋 🛼
拿捏	拿捏 🤌 🤌🏻 🤌🏼 🤌🏽 🤌🏾 🤌🏿
捏手指	捏手指 🤌 🤌🏻 🤌🏼 🤌🏽 🤌🏾 🤌🏿
格局小了	格局小了 🤌🤌🏻 🤌🏼 🤌🏽 🤌🏾 🤌🏿
含泪的笑脸	含泪的笑脸 🥲
忍者	忍者 🥷 🥷🏻 🥷🏼 🥷🏽 🥷🏾 🥷🏿
伪装	伪装 🥸
伪装的脸	伪装的脸 🥸
渡渡鸟	渡渡鸟 🦤
河狸	河狸 🦫
海狸	海狸 🦫
大野牛	大野牛 🦬
海豹	海豹 🦭
拖鞋	拖鞋 🩴
夹趾凉鞋	夹趾凉鞋 🩴
人字拖	人字拖 🩴
回旋镖	回旋镖 🪃
回力标	回力标 🪃
圣诞爆竹	圣诞爆竹 🪅
皮纳塔	皮纳塔 🪅
彩罐	彩罐 🪅
俄罗斯套娃	俄罗斯套娃 🪆
套娃	套娃 🪆
头盔	头盔 🪖
军用头盔	军用头盔 🪖
手风琴	手风琴 🪗
长鼓	长鼓 🪘
硬币	硬币 🪙
金币	金币 🪙
锯子	锯子 🪚
木工锯	木工锯 🪚
螺丝刀	螺丝刀 🪛
挂钩	挂钩 🪝
钩子	钩子 🪝
镜子	镜子 🪞
窗	窗 🪟
窗户	窗户 🪟
搋子	搋子 🪠
马桶塞	马桶塞 🪠
活塞	活塞 🪠
缝纫针	缝纫针 🪡
绣花针	绣花针 🪡
缝合针	缝合针 🪡
绳结	绳结 🪢
结	结 🪢
疙瘩	疙瘩 🪢
水桶	水桶 🪣
桶	桶 🪣
老鼠夹	老鼠夹 🪤
捕鼠器	捕鼠器 🪤
牙刷	牙刷 🪥
墓碑	墓碑 🪦
立牌	立牌 🪧
标语牌	标语牌 🪧
岩石	岩石 🪨
蠕虫	蠕虫 🪱
蚯蚓	蚯蚓 🪱
寄生虫	寄生虫 🪱
小强	小强 🪳
蟑螂	蟑螂 🪳
木头	木头 🪵
原木	原木 🪵
木桩	木桩 🪵
羽毛	羽毛 🪶
心脏	心脏 🫀
肺	肺 🫁
蓝莓	蓝莓 🫐
甜椒	甜椒 🫑
青椒	青椒 🫑
灯笼椒	灯笼椒 🫑
橄榄	橄榄 🫒
面饼	面饼 🫓
扁面包	扁面包 🫓
粽子	粽子 🫔
墨西哥粽子	墨西哥粽子 🫔
奶酪火锅	奶酪火锅 🫕
芝士火锅	芝士火锅 🫕
茶壶	茶壶 🫖
车轮	车轮 🛞
轮胎	轮胎 🛞
救生圈	救生圈 🛟
粗等号	粗等号 🟰
忍住泪水	忍住泪水 🥹
穴居巨怪	穴居巨怪 🧌
巨魔	巨魔 🧌
兽人	兽人 🧌
X射线	X射线 🩻
X光	X光 🩻
x射线	x射线 🩻
x光	x光 🩻
片子	片子 🩻
拐杖	拐杖 🩼
镜球	镜球 🪩
迪斯科球	迪斯科球 🪩
身份证	身份证 🪪
身份卡	身份卡 🪪
学生证	学生证 🪪
驾照	驾照 🪪
护照	护照 🪪
电池电量不足	电池电量不足 🪫
电量不足	电量不足 🪫
法蒂玛之手	法蒂玛之手 🪬
珊瑚	珊瑚 🪸
鸟巢	鸟巢 🪹 🪺
空巢	空巢 🪹
有蛋的巢	有蛋的巢 🪺
怀孕的男人	怀孕的男人 🫃 🫃🏻 🫃🏼 🫃🏽 🫃🏾 🫃🏿
怀孕男	怀孕男 🫃 🫃🏻 🫃🏼 🫃🏽 🫃🏾 🫃🏿
男妈妈	男妈妈 🫃 🫃🏻 🫃🏼 🫃🏽 🫃🏾 🫃🏿
啤酒肚	啤酒肚 🫃 🫃🏻 🫃🏼 🫃🏽 🫃🏾 🫃🏿 🫄 🫄🏻 🫄🏼 🫄🏽 🫄🏾 🫄🏿
怀孕的人	怀孕的人 🫄
戴王冠的人	戴王冠的人 🫅 🫅🏻 🫅🏼 🫅🏽 🫅🏾 🫅🏿
戴皇冠的人	戴皇冠的人 🫅 🫅🏻 🫅🏼 🫅🏽 🫅🏾 🫅🏿
倾倒液体	倾倒液体 🫗
倒茶	倒茶 🫗
倒水	倒水 🫗
倒牛奶	倒牛奶 🫗
倒饮料	倒饮料 🫗
豆	豆 🫘
豆子	豆子 🫘
红豆	红豆 🫘
罐子	罐子 🫙
空罐子	空罐子 🫙
空罐	空罐 🫙
罐	罐 🫙
融化	融化 🫠
致敬	致敬 🫡
敬礼	敬礼 🫡
睁眼捂嘴	睁眼捂嘴 🫢
偷看	偷看 🫣
虚线脸	虚线脸 🫥
咬住嘴唇	咬住嘴唇 🫦
咬嘴唇	咬嘴唇 🫦
气泡	气泡 🫧
泡泡	泡泡 🫧
食指与拇指交叉的手	食指与拇指交叉的手 🫰
食指拇指交叉	食指拇指交叉 🫰
比心	比心 🫰 🫶
向右的手	向右的手 🫱
向左的手	向左的手 🫲
掌心向下的手	掌心向下的手 🫳
掌心向上的手	掌心向上的手 🫴
指向观察者的食指	指向观察者的食指 🫵
做成心形的双手	做成心形的双手 🫶
wifi	wifi 🛜
WIFI	WIFI 🛜
无线	无线 🛜
沙球	沙球 🪇
沙槌	沙槌 🪇
长笛	长笛 🪈
笛子	笛子 🪈
笛	笛 🪈
折扇	折扇 🪭
扇子	扇子 🪭
发夹	发夹 🪮
发梳	发梳 🪮
梳子	梳子 🪮
风信子	风信子 🪻
洋水仙	洋水仙 🪻
水母	水母 🪼
翅膀	翅膀 🪽
驼鹿	驼鹿 🫎
驴	驴 🫏
姜	姜 🫚
豌豆	豌豆 🫛
毛豆	毛豆 🫛
荷兰豆	荷兰豆 🫛
豌豆荚	豌豆荚 🫛
向左推	向左推 🫷 🫷 🫷 🫷 🫷 🫷
向右推	向右推 🫸 🫸 🫸 🫸 🫸 🫸
鼠鼠我鸭	鼠鼠我鸭 🐭🐭🐌🦆 🐁🐁🤷🏻🦆
指鼠为鸭	指鼠为鸭 🈯🐭☎🦆 🫵🏻🐁📞🦆 
