即可	jk
按时	au
而是	eu
反应	fy
成为	iw
传统	it
计算	js
今晚	jw
精彩	jc
简单	jd
简直	jv
联系	lx
貌似	ms
每周	mv
期间	qj
任务	rw
台湾	tw
神似	us
试试	uu
知道	vd
只会	vh
只能	vn
只是	vu
现金	xj
小时	xu
一定	yd
一片	yp
一直	yv
一下	yx
基本	jb
什么	sm
极为	jw
即使	ju
不再	bz
背景	bj
达到	dd
恶毒	ed
儿科	ek
分别	fb
反对	fd
反悔	fh
附件	fj
过程	gi
回复	hf
程度	id
尝尝	ii
今天	jt
极其	jq
举例	jl
假如	jr
链接	lj
面前	mq
美丽	ml
那些	nx
那样	ny
努力	nl
歧视	qu
千万	qw
速度	sd
统一	ty
推导	td
伤害	uh
世纪	uj
束缚	uf
收到	ud
征服	vf
主意	vy
追求	vq
文字	wz
玩儿	we
猥琐	ws
为止	wv
微信	wx
西欧	xo
险恶	xe
修正	xv
选择	xz
下次	xc
下面	xm
云南	yn
在线	zx
总共	zg
总算	zs
按键	aj
整句	vj
按理	al
黯然	ar
暗自	az
五笔	wb
一边	yb
座位	zw
安全	aq
按照	av
安排	ap
按错	ac
安静	aj
昂贵	ag
安定	ad
安慰	aw
爱惜	ax
安保	ab
安分	af
拗口	ak
爱死	as
凹凸	at
安逸	ay
暧昧	am
挨饿	ae
必须	bx
不同	bt
保证	bv
并且	bq
必要	by
比赛	bs
本来	bl
不然	br
不饿	be
才能	cn
错误	cw
采取	cq
参考	ck
从来	cl
聪明	cm
从不	cb
从头	ct
才行	cx
存盘	cp
代表	db
地方	df
东西	dx
到了	dl
代替	dt
而且	eq
儿童	et
而已	ey
儿子	ez
恶搞	eg
而不	eb
耳机	ej
恶劣	el
二者	ev
额外	ew
而非	ef
噩梦	em
恩赐	ec
恩爱	ea
饿死	es
恶心	ex
恶评	ep
方面	fm
发现	fx
非常	fi
方便	fb
分配	fp
放弃	fq
繁体	ft
反而	fe
否认	fr
放松	fs
反馈	fk
烦恼	fn
反正	fv
讽刺	fc
功能	gn
根本	gb
过去	gq
沟通	gt
公平	gp
干嘛	gm
湖南	hn
好处	hi
后面	hm
回去	hq
害怕	hp
何必	hb
后天	ht
产品	ip
出现	ix
成本	ib
承诺	in
重启	iq
重码	im
解决	jj
结果	jg
金额	je
几乎	jh
解放	jf
骄傲	ja
节奏	jz
奇偶	jo
可能	kn
开头	kt
昆明	km
开车	ki
恐怖	kb
恐怕	kp
况且	kq
论坛	lt
了解	lj
浪费	lf
没有	my
目前	mq
明显	mx
明天	mt
默认	mr
难道	nd
脑子	nz
欧洲	ov
偶尔	oe
偶然	or
偶像	ox
欧阳	oy
呕吐	ot
培训	px
平台	pt
配置	pv
漂亮	pl
脾气	pq
配送	ps
普洱	pe
骗人	pr
拼音	py
其中	qv
确定	qd
缺乏	qf
其次	qc
亲自	qz
奇怪	qg
全额	qe
切换	qh
群殴	qo
日期	rq
认为	rw
日本	rb
热线	rx
认真	rv
人们	rm
容易	ry
人类	rl
认可	rk
热爱	ra
认同	rt
热闹	rn
人品	rp
认得	rd
所以	sy
思想	sx
思考	sk
所谓	sw
似乎	sh
随便	sb
索取	sq
算了	sl
索赔	sp
随你	sn
洒脱	st
特别	tb
讨论	tl
同学	tx
天气	tq
天天	tt
头发	tf
首先	ux
事情	uq
身体	ut
上面	um
顺便	ub
双拼	up
这样	vy
掌握	vw
准备	vb
正确	vq
这么	vm
折腾	vt
只怕	vp
我们	wm
问题	wt
完成	wi
为了	wl
完全	wq
唯一	wy
微软	wr
为此	wc
无奈	wn
唯恐	wk
网盘	wp
现在	xz
需要	xy
希望	xw
喜欢	xh
西安	xa
相当	xd
习惯	xg
相反	xf
下周	xv
要求	yq
因为	yw
应该	yg
原来	yl
缘分	yf
郁闷	ym
自己	zj
作品	zp
自然	zr
怎么	zm
怎样	zy
昨天	zt
走了	zl
暂且	zq
怎能	zn
咋不	zb
最快	zk
参加	cj
从前	cq
电脑	dn
打算	ds
等着	dv
分钟	fv
发送	fs
否则	fz
刚刚	gg
感觉	gj
公司	gs
更新	gx
规则	gz
跟着	gv
绝对	jd
尽管	jg
渐渐	jj
困难	kn
慢慢	mm
每天	mt
情况	qk
前面	qm
恰恰	qq
仍然	rr
虽然	sr
搜索	ss
随着	sv
推广	tg
推荐	tj
淘汰	tt
投资	tz
这次	vc
支持	vi
真正	vv
这些	vx
味道	wd
完美	wm
修改	xg
学习	xx
正在	vz
周围	vw
最终	zv
确认	qr
偶发	of
分类	fl
安装	a
比较	b
词库	c
大概	d
嗯嗯	e
复杂	f
关系	g
忽略	h
重新	i
键盘	j
可以	k
理解	l
目录	m
内容	n
哦哦	o
便宜	p
其他	q
然后	r
所有	s
提供	t
时候	u
直接	v
位置	w
显示	x
已经	y
自动	z