么	幺
偽	僞
凶	兇
啟	啓
媯	嬀
嫻	嫺
峰	峯
床	牀
才	纔
抬	擡
晒	曬
核	覈
汙	污
洩	泄
湧	涌
溈	潙
潀	潨
灶	竈
為	爲
痴	癡
痺	痹
眾	衆
睪	睾
稜	棱
簷	檐
粽	糉
缽	鉢
群	羣
著	着
蒍	蔿
裡	裏
踴	踊
韁	繮
顎	齶
鯰	鮎
麵	麪
